Gestirn	drehen	SYN
Zauberer	Magier	SYN
mutig	Grund	RANDOM
Kaufen	Verbreitung	RANDOM
Sonde	Anfrage	HYPER
Elektrode	Batterie	PART_OF
gewöhnliche	Wasserfall	RANDOM
clarion	ausrufen	HYPER
Negativität	Positivität	ANT
mittschiffs	midships	SYN
relishing	genießen	SYN
Nussbaum	Nussbaum	PART_OF
vorspannen	Mannschaft	RANDOM
expansiv	gesprächig	SYN
Erzählung	Botschaft	HYPER
Weide	Weide	SYN
Kessel	Gebäude	PART_OF
Wechsler	Grammophon	PART_OF
noncombatant	serviceman	HYPER
Heidelbeere	Heidelbeere	PART_OF
Tastatur	unzufrieden	RANDOM
hopefulness	Hoffnungslosigkeit	ANT
bema	Kirche	PART_OF
Geburtstag	Himmel	RANDOM
Dirigent	Isolator	ANT
Fach	Stereotyp	SYN
Nachzügler	Faulenzer	HYPER
verarbeiten	Befehl	HYPER
Objekt	Leise	RANDOM
Gehirn	Radio	RANDOM
pectoralis	Wirbeltier	PART_OF
Bar	Handlung	RANDOM
verwendbar	arbeitsunfähig	ANT
herrlich	prächtig	SYN
nachdrücklich	energisch	SYN
abnehmend	Waxing	ANT
Cent	Gulden	PART_OF
Lauch	Lauch	PART_OF
Arktis	gumshoe	SYN
Opal	Juwel	HYPER
Senkung	Zusammenbruch	HYPER
Lärm	verlassen	RANDOM
Verkaufstechnik	Erwerb	HYPER
Gang	gut	RANDOM
Sachen	Besitz	HYPER
Arena	Schüssel	SYN
Reich	robust	SYN
Flugzeug	Pflanze	RANDOM
zensiert	unzensiert	ANT
Verallgemeinerung	Lernen	HYPER
Asien	Zehe	RANDOM
Kohle	wampum	SYN
Pansen	Wiederkäuer	PART_OF
Widerstandsfähigkeit	Gültigkeit	SYN
Schild	Weichtier	PART_OF
Schürze	Transit	PART_OF
Aggregator	Sein	HYPER
erinnern	wollen	HYPER
geplanter Termin	Entschlossenheit	HYPER
Künstler	jemand	HYPER
existent	nicht existent	ANT
demonstrativ	illustrativ	SYN
eff	Paar	HYPER
Pekari	Huftier-	HYPER
wilding	Amoklauf	HYPER
Pünktlichkeit	Verspätung	ANT
schwirren	Auftreten	HYPER
Nase	Metall	RANDOM
Umkehrung	Kehrtwendung	SYN
Wirksam	unwirksam	ANT
Hochland	Flachland	ANT
Kilobyte	Gigabyte	PART_OF
frisch	konserviert	ANT
brachial	Fauna	SYN
qualifiziert	unqualifiziert	ANT
definiert	skizzierte	SYN
Augur	Omen	SYN
Kennzeichen	Pflege	RANDOM
Krankheit	Trainer	RANDOM
Untertitel	Film	PART_OF
Klaue	angreifen	HYPER
Aktivator	Inhibitor	ANT
Edelmann	Edelfrau	ANT
unerträglich	nicht akzeptabel	SYN
Unbrauchbarkeit	Durchführbarkeit	ANT
kaltblütig	warmblütig	ANT
unerreicht	unerreicht	SYN
Stuhl	Werkzeug	RANDOM
Auslöschung	Geburtswehen	PART_OF
Athlet	hart	RANDOM
Augapfel	oculus	PART_OF
schön	Brief	RANDOM
gigantisch	kolossal	SYN
verschmelzen	verschmelzen	SYN
betätigen	prompt	SYN
Mitglied	Flur	RANDOM
Maniok	Maniok	HYPER
herrisch	stolz	SYN
Schwere	Leichtigkeit	ANT
Lametta	ändern	HYPER
Razzia	Verhütung	HYPER
Leck	umkehren	RANDOM
Vorhersagbarkeit	Unberechenbarkeit	ANT
Innenstadt	Villenviertel	ANT
implausibility	Plausibilität	ANT
Kalb	schreien	RANDOM
wichtig	unwichtig	ANT
Hähnchen	Angelegenheit	RANDOM
pica	Zoll	PART_OF
Flaute	Stille	HYPER
Schuld	Unschuld	ANT
koordiniertes	koordinierte	SYN
Hyperglykämie	Hypoglykämie	ANT
bezahlt	zahlen	SYN
Verstand	Schatten	RANDOM
Übereinstimmung	harmonisieren	SYN
Gully	Tal	HYPER
Strebe	stolzieren	SYN
Gerangel	agitieren	HYPER
Darm	Bauch	PART_OF
sommerlich	winterlich	ANT
Disziplin	Disziplinlosigkeit	ANT
unbescheiden	bescheiden	ANT
Verwechslung	Unordnung	SYN
Schott	Trennwand	HYPER
schlagen	perforieren	HYPER
Säure	Alkalinität	ANT
beladen	unburdened	ANT
China	Gift	RANDOM
cl	l	PART_OF
einträgliche Sache	Programm	HYPER
Anbauer	Jack	HYPER
Basketball	Vakuum	RANDOM
bedeuten	Spiel	RANDOM
Dolle	Schlauchboot	PART_OF
Frivolität	Schwere	ANT
Antonym	Synonym	ANT
Clinch	Zwang	HYPER
Wiederverkauf	Handel	HYPER
Umstellung	Verschiebung	HYPER
Metzger	schlachten	SYN
Kiefer	caput	PART_OF
Jacke	kurz	RANDOM
Verschiebung	Übersetzung	HYPER
Atemloch	Gebläse	PART_OF
Zitrone	Zitrone	PART_OF
beunruhigt	unbeschwert	ANT
Fluch	fluchen	SYN
Berg	sprechen	RANDOM
vernichten	entwurzeln	SYN
Vorderseite	Schlachtfeld	PART_OF
Monismus	Pluralismus	ANT
Dämmerung	Vorabend	PART_OF
die Genehmigung	Missbilligung	ANT
überzeugend	nicht überzeugend	ANT
Vizekönigtum	Zuständigkeit	HYPER
Schablone	drucken	HYPER
Boot	Aufzug	RANDOM
Verengung	Erweiterung	ANT
Pazifismus	Lehre	HYPER
Matrix	o	PART_OF
glücklich	vergnügt	SYN
Zahlen	Haut	RANDOM
Brust	wohnen	RANDOM
Weiblichkeit	Männlichkeit	ANT
gekocht	roh	ANT
Verzweiflung	Hoffnung	ANT
antecedent	anschließend	ANT
generisch	Sorten	ANT
Ladeprogramm	Arbeiter	HYPER
Klette	Perikarp	HYPER
Rindfleisch	Sonnenschein	RANDOM
zischen	trinkbar	HYPER
Kilogramm	metrisch	HYPER
Angstrom	Mikron	PART_OF
Radom	Flugzeug	PART_OF
konservativ	Liberale	ANT
Anode	Schaltung	PART_OF
Klasse	groß	RANDOM
Versprechen	Portion	HYPER
Alter	Lebenszeit	PART_OF
komplizieren	Ärger	HYPER
Sünde	überschreiten	HYPER
stopfen	bereit	HYPER
lose	Kopf	RANDOM
Abstieg	Kompartimentierung	HYPER
maximal	Minimum	ANT
mich	Versuch	RANDOM
Unabänderlichkeit	Umkehrbarkeit	ANT
Behandlung	Tat	HYPER
Versprechen	Preis-	HYPER
Kauen	Ernährung	PART_OF
Anruf	Unterstützung	RANDOM
Tempo	Gehen	PART_OF
Arbeitsplatte	Tischplatte	HYPER
Mikado	Kaiser	HYPER
Schriftführer	Schiedsrichter	HYPER
unempfänglich	unberührt	SYN
Nukleon	Kern	PART_OF
erkennbar	offensichtlich	SYN
Bit	Demokratie	RANDOM
Hypertonie	Unterdruck	ANT
Händler	Händler	SYN
Empfehlung	Zeugnis	SYN
Pest	Bestimmer	HYPER
Stoßstange	Automobil	PART_OF
Verantwortungslosigkeit	Verantwortung	ANT
Direkte	rückläufig	ANT
desensibilisieren	ändern	HYPER
Paraquat	Herbizid	HYPER
Neu	Star	RANDOM
ab	Abdomen	PART_OF
Verspottung	fragend	SYN
in Ordnung	autorisieren	HYPER
realistisch	unrealistisch	ANT
Schärfe	Weichheit	ANT
Eiweiß	Albumin	SYN
Haus	Geld	RANDOM
induziert	spontan	ANT
springen	sterblich	RANDOM
Pfund	Zentner	PART_OF
blank	bedeckt	ANT
Finanz-	nicht-finanzielle	ANT
Hier	Dort	ANT
zerfallen	ändern	HYPER
Sanftmut	Einreichung	SYN
abtreten	Kapitulation	SYN
Drohne	Dudelsack	PART_OF
kann	Domizil	PART_OF
blühen	Angiospermen	PART_OF
Gans	zwicken	HYPER
Nachwuchs	hoch	RANDOM
Grenze	Grenzen	SYN
insectivorous	omnivor	ANT
Unterschall	Überschall-	ANT
Verfassung	Attribut	HYPER
Becher	jock	HYPER
Cannabis	Scheibe	RANDOM
Befreier	Befreier	HYPER
gesprächig	talky	SYN
stürzen	konzentrieren	HYPER
empirisch	theoretisch	ANT
curmudgeonly	schroff	SYN
Badende	jemand	HYPER
Kollaborateur	Mitarbeiter	SYN
direkt	unverzüglich	SYN
bunsen	etna	SYN
Wird geladen	Entladung	ANT
schlachten	Schlächterei	PART_OF
Empfangshalle	benutzen	RANDOM
unaufrichtig	aufrichtig	ANT
peinlich	schwerfällig	SYN
Scharnier	Automobil	PART_OF
Rufweite	erreichen	HYPER
Besetzung	Würfelspiel	PART_OF
Angelegenheit	gehen	RANDOM
Konzeption	Missverständnis	ANT
Bullauge	Rumpf	PART_OF
Kampf	Versuchen	HYPER
Dunkelheit	Bedeutung	ANT
beschädigt	unbeschädigt	ANT
Schwengel	Rachen	PART_OF
vorrücken	Rückzug	ANT
drumlin	Masse	HYPER
Morgen	zerbrechlich	RANDOM
Niveau	Frau	RANDOM
Mississippi	Fahrzeug	RANDOM
ungebildet	unerzogen	SYN
Luft-zu-Luft-	Luft-zu-Oberfläche	ANT
Off-Shore	Land-	ANT
Basketball	persönlich	RANDOM
Knoten	Traum	RANDOM
Feige	Illustration	HYPER
Kerl	feller	SYN
grasen	Rechen	SYN
stechen	Aktivität	HYPER
scripted	improvisiert	ANT
Kiel	Wasserfahrzeug	PART_OF
Postleitzahl	Schreiben	PART_OF
günstig	ungünstig	ANT
demokratisch	undemokratisch	ANT
lästig	langweilig	SYN
erarbeiten	erhellen	HYPER
Fledermaus	Fenster	RANDOM
sperren	Star	RANDOM
Knoten	Stunde	RANDOM
Ader	Magnet	PART_OF
Schaufel	Hubschrauber	PART_OF
ständig	schwankend	ANT
vorrücken	Socke	RANDOM
Boden	zurückhalten	HYPER
Karte	Objekt	RANDOM
Baracke	erhöhen	HYPER
Verlogenheit	Richtigkeit	ANT
Einrichtung	Regierung	PART_OF
Arbeit	Schwangerschaft	PART_OF
Bein	missverstehen	RANDOM
Sauerklee	Sauerampfer	SYN
Schiefe	Schwangerschaft	PART_OF
Pistazie	Pistazie	PART_OF
Brautwerbung	Gebet	HYPER
geringer	verzeihlich	SYN
Glatzkopf	jemand	HYPER
Lüge	Falschheit	SYN
Sklera	optisch	PART_OF
fast~~POS=TRUNC	Lieferung	HYPER
Pflege	Bild	RANDOM
Kette	abspielen	RANDOM
Penis	Industrie	RANDOM
Gespinst	durchschauen	SYN
ermahnen	Rede	HYPER
Kanon	Schlucht	HYPER
Kondensation	Verdichtung	SYN
versüßen	ändern	HYPER
mondlos	mondbeschienen	ANT
kompetent	inkompetent	ANT
Kettenrad	Kamera	PART_OF
Krankenschwester	Kindermädchen	SYN
Mittelteil	Torso	PART_OF
Anfang	erschrecken	SYN
Zivilisation	Stier	RANDOM
Entscheidung	Unentschlossenheit	ANT
Prügel	Tracht Prügel	SYN
Vernähen	Betrieb	PART_OF
kritisch	Kreuzung	HYPER
wechseln	Gegenteil	ANT
diploiden	haploid	ANT
Draht	ordnen	HYPER
Darsteller	Spiel	RANDOM
Fledermaus	Material	RANDOM
Kauen	Essen	PART_OF
Wandschrank	kurz	RANDOM
Verkleidung	Gebäude	PART_OF
Wachsamkeit	Aufmerksamkeit	HYPER
impotent	potent	ANT
verzweifelt	dringend	SYN
Schaum	zischen	HYPER
Medizin	Gewehr	RANDOM
Autor	flach	RANDOM
Jogginghose	schwitzt	PART_OF
Gütesiegel	Dichtung	HYPER
Zentralisierung	Dezentralisierung	ANT
Station	Krankenhaus	PART_OF
Anfang	zuerst	SYN
Tunika	Tunica	SYN
erwerben	Lokalisieren	HYPER
tragen	Aussicht	RANDOM
Divination	Prophezeiung	SYN
Himmel	Region	HYPER
Christian	Fahrzeug	RANDOM
Künstler	Krieg	RANDOM
reuig	reulos	ANT
Krankheit	Badezimmer	RANDOM
modisch	unmodern	ANT
Bewegung	Maus	RANDOM
Schaft	Handwagen	PART_OF
Quartal	Zentner	PART_OF
Party	Anzahl	RANDOM
obligatorisch	wahlweise	ANT
polternd	stürmisch	SYN
Schuld	gesegnet	SYN
Auftrag	Proton	RANDOM
Asien	Anweisung	RANDOM
maximal	Minimum	ANT
Unparteilichkeit	Parteilichkeit	ANT
Teufel	Nessel	SYN
Uhr	Menge	RANDOM
Zuweisung	Treffen	HYPER
Spaltung	ordentlich	SYN
Rückkehr	Antwort	HYPER
Luft	verlassen	RANDOM
Analytiker	Psychoanalytiker	SYN
Verbrennung	Verbrennung	HYPER
Auftrieb	fördern	SYN
Soja	Sojabohne	PART_OF
sausen	Postleitzahl	HYPER
Sardine	Chalzedon	HYPER
Stator	Gebläse	PART_OF
Milliliter	dl	PART_OF
Beistand	Beistand	SYN
Schießen	Schuss	SYN
Rotor	Hubschrauber	PART_OF
Geschmack	Ton	SYN
mager	geizig	SYN
Duldung	erlauben	HYPER
Kochen	kochen	SYN
Runway	Straßenbahnlinie	PART_OF
Kreis	Prüfung	RANDOM
narthex	Kirche	PART_OF
Apfel	Säugetier	RANDOM
verfälschen	manipulieren	SYN
Ableben	Lebenszeit	PART_OF
Ross	montieren	HYPER
Unvollkommenheit	Perfektion	ANT
neunziger Jahre	Zeitraum	HYPER
Anker	Klaue	HYPER
Stadt	Freundin	RANDOM
Bug	Wasserfahrzeug	PART_OF
Beginn	Abschluss	SYN
Chili	Jalapeno	PART_OF
Center	Summe	SYN
schlagen	Brust	RANDOM
Wiederherstellung	Wiedergutmachung	HYPER
jährlich	zweijährig	ANT
Knurren	verzerren	HYPER
Konzentration	Verdünnung	ANT
Tante	Onkel	ANT
Junge	Recht	RANDOM
zur Seite fahren	Kleidungsstück	HYPER
Uvula	Gaumen	PART_OF
Gitter	Gitterwerk	SYN
Nichtzahlung	Zahlung	ANT
Darm	Torso	PART_OF
Wolke	Schlaf	RANDOM
Rauheit	Glätte	ANT
Thymusdrüse	endokrin	HYPER
Vermarkter	Verkäufer	SYN
verrückt	wütend	SYN
abgesenkt	angehoben	ANT
unlöslich	löslich	ANT
Kompetenz	Inkompetenz	ANT
irreversibel	reversibel	ANT
Hüfte	Rosenstrauch	PART_OF
Süßigkeiten	dunkel	RANDOM
escarole	Endivie	PART_OF
Beute	Shake	HYPER
Umfrage	Pollard	SYN
Fehler	Buch	RANDOM
Keimung	sprießen	SYN
Haselnuss	Hasel	PART_OF
roter Ziegelstein	roter Ziegelstein	SYN
Schwall	Rave	SYN
Gefängnis	Problem	RANDOM
Film	RAM	RANDOM
Filet	Portion	HYPER
Konstante	unbeständig	ANT
Stele	Achse	PART_OF
Kaufen	Zimmer	RANDOM
Duplikat	prüfen	HYPER
Kodizill	Testament	PART_OF
clementine	Zitrusgewächs	HYPER
Tasche	erwerben	HYPER
Abenteuer	denken	RANDOM
Neuling	Anfänger	HYPER
frivol	ernst	ANT
zungenfertig	glatt	SYN
Zuschreibung	Zuschreibung	SYN
Schnurrbart	Schnurrhaare	PART_OF
Kapitän	Integrität	RANDOM
zirkulieren	verdrängen	HYPER
Klammer	bearbeiten	HYPER
Mirasol	helianthus	HYPER
käsig	blechern	SYN
verheddert	entwirrt	ANT
veranschaulichen	Beispiel	SYN
Aktion	Deckel	RANDOM
Bulgur	Tabouleh	PART_OF
Brücke	Halle	RANDOM
dramatisieren	verschönern	SYN
Sequenz	pic	PART_OF
rücksichtsvoll	rücksichtslos	ANT
auftreffen	Graben	SYN
Gehirn	unzufrieden	RANDOM
Brücke	Wort	RANDOM
Geschirr	Rutsche	PART_OF
Park	Menge	RANDOM
Bein	Mathematik	RANDOM
Geburtstag	Angst	RANDOM
Gipfel	Spitze	HYPER
mieten	wohnen	RANDOM
Umfang	Radar	PART_OF
Irland	Streik	RANDOM
Biege	Bergwerk	RANDOM
Stator	glattere	PART_OF
Schaft	Hörer	PART_OF
Braten	Kochen	HYPER
Papier-	Pflanze	RANDOM
Cere	Feder	HYPER
Haselnuss	Hasel	PART_OF
Entwurf	Mobilisierung	HYPER
dirge	Klage	SYN
Konto	Sonnenschein	RANDOM
3	iii	SYN
spritzen	entladen	HYPER
Veränderung	Hand	RANDOM
Liter	hectoliter	PART_OF
Masse	Flut	SYN
kobo	Naira	PART_OF
Kanal	Seele	RANDOM
geweiht	geschändet	ANT
Leck	trainieren	RANDOM
Rüsche	Nerven	HYPER
Baumwollsaat	Baumwolle	PART_OF
Kumpel	Freund	SYN
bewundern	Insel	RANDOM
nontraditional	traditionell	ANT
fremd	Einheimische	ANT
intim	vorschlagen	SYN
verschönern	sticken	SYN
bedeuten	Gedicht	RANDOM
Halfter	Geschirr	PART_OF
Welle	Gebäude	PART_OF
Kaiser	nymphalid	HYPER
bespielbar	unspielbar	ANT
Messe	unfair	ANT
Störung	Kampf	HYPER
saftig	glühend	SYN
springer	Kolonnade	PART_OF
Unterbau	System	PART_OF
Berg	springen	RANDOM
slops	Gesöff	SYN
niedriger	Vater	RANDOM
schusseln	stocken	SYN
umstritten	unverfänglich	ANT
Clownerie	Clownerie	SYN
Schlag	Lösung	RANDOM
Visa	Reisepass	PART_OF
Bar	Geschenk	RANDOM
Farthing	Hartgeld	HYPER
Matrix	Knochen	PART_OF
Interferenz	Noninterference	ANT
Gallone	Quartal	PART_OF
pflanzenfress	insectivorous	ANT
Riss	Änderung	HYPER
Flugzeug	hart	RANDOM
früh	spät	ANT
alkoholisch	nicht alkoholisch	ANT
Fahrer	messen	PART_OF
Lampenschirm	Lampe	PART_OF
groß	Sonnenschein	RANDOM
trüb	durchschauen	SYN
Körperbau	jemand	PART_OF
gesprochen	Zyklus	PART_OF
Nacktheit	Offenheit	SYN
Rezitation	Kurs	PART_OF
alt	klingen	RANDOM
Knoten	Album	RANDOM
jucken	schmerzen	HYPER
erschöpfend	gründlich	SYN
Mittagessen	Aufzug	RANDOM
Thron	Wohnung	PART_OF
Badewanne	energisch	RANDOM
beschichtete	unbeschichtetem	ANT
Erwiderung	Replik	SYN
Kenntnisnahme	Durchlesen	SYN
Echolot	U-Boot	PART_OF
Linse	wütend machen	RANDOM
Direkte	indirekt	ANT
Loch	ungebrochen	RANDOM
Fahrbahn	Autobahn	PART_OF
Biotechnologie	Ergonomie	SYN
vorschlagen	erklären	HYPER
kauen	Vergangenheit	RANDOM
Schokolade	Nieder	RANDOM
Fledermaus	Arbeit	RANDOM
Uhr	Krug	RANDOM
Auto	Element	RANDOM
monetarisieren	legitimieren	HYPER
Blockade	behindern	SYN
Pförtner	Ursache	HYPER
Ungeduld	die Geduld	ANT
Midi-	Mini	ANT
Grill	Picknick	HYPER
Segeltuch	Hintergrund	HYPER
karminrot	cerise	SYN
huschen	Geschwindigkeit	HYPER
Kaiserliche	lila	SYN
Taro	Taro	PART_OF
versichert	unversichert	ANT
schonen	Portion	HYPER
Macula	oculus	PART_OF
chevy	Ärger	SYN
Bergab	Neigung	HYPER
Mass angefertigt	fertig	ANT
gefalzt	nahtlos	ANT
ordnen	Frisur	SYN
scharrt	Kauen	HYPER
Erzherzogin	Prinzessin	HYPER
Handgelenk	Arm	PART_OF
Begleitet	Begleiter	SYN
Wirksamkeit	Ineffizienz	ANT
Krebs	Sport	RANDOM
Osteopath	Experte	HYPER
Zivilisation	Familie	RANDOM
Diwan	Salon	HYPER
heterosexuell	Bühne	RANDOM
Stuhl	Lied	RANDOM
Popularität	Unbeliebtheit	ANT
Hilfe	Höhle	RANDOM
corneum	Kutikula	PART_OF
Verkauf	Großhandel	ANT
offiziell	inoffiziell	ANT
Gang	Gras	RANDOM
30	xxx	SYN
beschattet	nicht schattiert	ANT
Überschreibung	Herrschaft	HYPER
grobkörnig	couragiert	SYN
Bataillon	Pluralität	SYN
Deckel	so tun als ob	RANDOM
Schulhaus	Infrastruktur	PART_OF
Ohnmacht	Synkope	SYN
umarmen	ballen	HYPER
mutig	Stelle	RANDOM
atonal	tonal	ANT
Entdeckung	Aufdeckung	SYN
Gang	engagieren	RANDOM
Richter	Nische	RANDOM
gewürzt	ungewürzt	ANT
Fabel	Legende	SYN
Verpackung	Artefakt	HYPER
Zahl	jemand	PART_OF
Busen	Kleidungsstück	PART_OF
elastisch	unelastisch	ANT
Vulva	Gemeine	HYPER
buffoonish	albern	SYN
Bekanntschaft	Fremder	ANT
Apfel	Post	RANDOM
teilbar	unteilbar	ANT
Sektor	Block	PART_OF
Basketball	weit	RANDOM
annektieren	Zusatz	HYPER
Lüge	Fahrzeug	RANDOM
verzerren	Tönung	SYN
Selbstbewusstsein	wissend	HYPER
Hier	Dort	ANT
Kanal	Stock	RANDOM
Kompression	Dekompression	ANT
begraben	legen	HYPER
geführt	ungelenkte	ANT
Integration	Trennung	ANT
Möwe	verraten	HYPER
Boot	Ideologie	RANDOM
Sojabohne	Soja	PART_OF
Gehäuse	Schwelle	PART_OF
unter der Annahme	anmaßend	SYN
Absackung	Entlassung	SYN
lyrisch	Niveau	RANDOM
cytokinesis	Meiose	PART_OF
Ehrlichkeit	erleuchten	RANDOM
Außen	Innere	ANT
Schalldämpfer	Gen	HYPER
geschlossen	verhindern	HYPER
Geburtstag	Demokratie	RANDOM
flussabwärts	upriver	ANT
Versuchung	beeinflussen	HYPER
veraltet	archaisch	SYN
Schnabel	Rahmen	RANDOM
verletzen	Baum	RANDOM
Vordergrund	interpunktieren	HYPER
Maschine	töten	RANDOM
Rotte	abheben	HYPER
perfide	heimtückisch	SYN
wechseln	zweite Besetzung	SYN
Mitglied	positiv	RANDOM
Unterhose	Strumpfhose	PART_OF
fast	in der Nähe von	SYN
Fettigkeit	Magerkeit	ANT
beseitigen	Freisetzung	HYPER
Glätte	Betrügerei	SYN
zurückhalten	hemmen	HYPER
Segeltuch	Segeltuch	HYPER
Annahme	Ablehnung	ANT
Kapazität	Schaltung	PART_OF
Kohärenz	Zusammenhanglosigkeit	ANT
blutrot	rötlich	SYN
Uhr	spucken	RANDOM
Runde	Kleidungsstück	PART_OF
Zeitraum	Äon	PART_OF
Heide	Ödland	HYPER
offen	geradeheraus	SYN
Fernrohr	zerquetschen	HYPER
Joggen	Gang	RANDOM
Ozean	Not	RANDOM
Kichern	Äußerung	HYPER
Eigenartigkeit	Individualismus	HYPER
Krankheit	Boden	RANDOM
Kiefer	Futter	PART_OF
antimikrobielle	Desinfektionsmittel	SYN
Unabhängigkeit	Kopf	RANDOM
Kilowatt	Megawatt	PART_OF
Geburt	Waffe	RANDOM
Schädel	caput	PART_OF
Entwurf	Portion	HYPER
antagonistisch	versöhnlich	ANT
Stift	RAM	RANDOM
Mehrheit	Minderheit	ANT
Schnitzer	Schnitzer	SYN
unpraktisch	praktisch	ANT
Aufstieg	Abstammung	ANT
Monsun	Untergang	HYPER
Kardinal	zentral	SYN
arb	Bourgeois	HYPER
Wiegenlied	Vokal	HYPER
genießen	Ernährung	HYPER
Einschnitt	Chirurgie	PART_OF
Gaze	Flicken	PART_OF
Goldgrube	Fallobst	SYN
Terror	Lausbub	HYPER
versteifen	prüfen	HYPER
konter	Revolutionär	ANT
G	hg	PART_OF
schlaff	Plattform	PART_OF
Heft	Marke	PART_OF
Zitrone	Gelb	HYPER
Millimeter	cm	PART_OF
Ball	heiraten	RANDOM
endogamy	exogamy	ANT
Blatt	schreien	RANDOM
Mondstrahl	Mondlicht	PART_OF
Weiß	Eier	PART_OF
limbed	astlos	ANT
Grabstein	Grabstein	SYN
peinlich	anmutig	ANT
Flüssigkeit	Flug	RANDOM
Kumquat	Kumquat	PART_OF
hohl	Gefängnis	RANDOM
Index	abspielen	RANDOM
achtziger Jahre	eld	PART_OF
faul	Rang	RANDOM
geminate	verdrängen	HYPER
befallen	belästigen	SYN
Beschleunigung	Schwangerschaft	PART_OF
undicht	fest	ANT
bunt	schlagen	HYPER
Karte	Seite	RANDOM
vierte	Quartal	SYN
Leben	Job	RANDOM
Mark	Summe	SYN
Zahlen	abspielen	RANDOM
Mittelklasse	Oberschicht	ANT
Jagd	vergolden	HYPER
Allgemeines	Spezifisch	ANT
Stumpf	Gitter	PART_OF
quer	längs	ANT
herrlich	unrühmlich	ANT
Freund	Griff	RANDOM
hämorrhagische	hämorrhagischen	SYN
maßgebend	klassisch	SYN
Langeweile	Kultur	RANDOM
Diorama	Panorama	SYN
Wasservogel	Schwimmvogel	SYN
crystalized	glasiert	SYN
Glauben	Mensch	RANDOM
Behälter	Blatt	RANDOM
hinreichend	unzureichend	ANT
Hersteller	Besorgnis	HYPER
Verspaar	twosome	SYN
Schale	Stengel	SYN
Kaschunuss	Kaschunuss	PART_OF
Schlüssel	Zucker	RANDOM
rekonstruieren	bewerten	HYPER
Medizin	Kette	RANDOM
Installation	Rate	SYN
cm	dm	PART_OF
endogamous	exogame	ANT
Mandarin	Mandarin	PART_OF
Interdependenz	Gegenseitigkeit	SYN
fragend	Neckerei	SYN
Ehre	Position	HYPER
Band	Muskulatur	PART_OF
fertig	unvollendet	ANT
Müllhalde	Kumulus	HYPER
Funk	Rückstoß	SYN
Tunte	sticken	HYPER
Quecksilber	Wald	RANDOM
Treue	Untreue	ANT
immaterielle	greifbar	ANT
fälschen	Original-	ANT
Gebeine	Klöppel	SYN
ungeordnet	organisiert	ANT
Verfügbarkeit	Unverfügbarkeit	ANT
gegenseitig	reziprok	SYN
Gutschein	Fan	HYPER
Plural-	Singular	ANT
gespalten	seziert	SYN
artikulieren	liefern	HYPER
beißend	bitter	SYN
Süßkartoffel	Süßkartoffel	PART_OF
hohl	Skelett	RANDOM
Grundpfeiler	Arkade	PART_OF
Komiker	Comic	SYN
dementieren	negieren	HYPER
Missverhältnis	Anteil	ANT
ausschließlich	einzig und allein	SYN
Getriebegehäuse	Fall	HYPER
schwerelos	gewichtig	ANT
Elastizität	Druckknopf	HYPER
leisten	erreichen	SYN
Inhalation	Atmung	PART_OF
gauss	tesla	PART_OF
Ehrerbietung	Höflichkeit	HYPER
Pentobarbital	Barbiturat	HYPER
Schulleiter	Darlehen	PART_OF
Einstrahlungs	Therapie	HYPER
Wette	Spekulation	HYPER
murrend	Grollen	SYN
Kürzung	Länge	HYPER
Gesichts-	caput	PART_OF
Ball	Nadel	RANDOM
Sicherheitsgurt	Verkehrsflugzeug	PART_OF
Cellophan	Verpackung	HYPER
Stift	Tod	RANDOM
Schwerlast	light-duty	ANT
Sweatshirt	Trainingsanzug	PART_OF
grau	gräulich	SYN
Diele	Automobil	PART_OF
Trommelschlägel	Geflügel	PART_OF
gebrandmarkt	Markenlos	ANT
Kavalkade	Prozession	HYPER
aah	in Worte fassen	HYPER
glücklich	unglücklich	ANT
Sülze	Stärke	HYPER
Atheismus	Theismus	ANT
generieren	machen	SYN
Kelch	blühen	PART_OF
Fahrbahn	thruway	PART_OF
reinigen	Wetter	RANDOM
Journalist	Journalist	HYPER
kaltherzig	warmherzig	ANT
Geburt	Zeit	RANDOM
Transporter	Fabrik	PART_OF
gehegten	kostbar	SYN
Korbflechterei	Kunst	HYPER
Neu	Dach	RANDOM
Tinte	Wald	RANDOM
angegurteten	unbelted	ANT
hat verloren	Gerettet	ANT
maillot	Badeanzug	HYPER
herbstlich	Frühlings-	ANT
Badewanne	Hündin	RANDOM
Keller	einfrieren	RANDOM
Stift	Regen	RANDOM
Türknauf	Gebäude	PART_OF
Existenz	Nicht-Existenz	ANT
Wette	Schwimmbad	PART_OF
Unrechtmäßigkeit	Legitimität	ANT
Zehennagel	pes	PART_OF
hörbar	unverständlich	ANT
störend	beunruhigend	SYN
Karosserie	Verknüpfung	RANDOM
Decke	Instrument	RANDOM
vergleichbar	unvergleichlich	ANT
kurzsichtig	kurzsichtig	SYN
Grundlage	Erläuterung	PART_OF
Babysitter	stander	ANT
unnachgiebig	lenkbar	ANT
wiedergekäutes Futter	Bit	HYPER
Karosserie	Recht	RANDOM
Acetaminophen	Medikation	HYPER
Markt	Stich	RANDOM
perfekt	Zigarette	RANDOM
Lehrplan	Botschaft	HYPER
Schlafen	wachend	ANT
Wendel	Quirl	SYN
Rüstung	Abrüstung	ANT
Zahlen	Saft	RANDOM
bod	jemand	PART_OF
Baseball	Bewegung	RANDOM
mittelmäßig	vernünftig	SYN
verschönern	Polster	SYN
Ignoranz	Gericht	RANDOM
zuerst	Weltklasse	SYN
Anlauf	Bowling	PART_OF
geographisch	magnetisch	ANT
Kalmus	Gefieder	PART_OF
Aufregung	tiff	SYN
stürzen	Anfang	HYPER
patriotisch	unpatriotisch	ANT
treibend	ziellos	SYN
Rechnung	erweitern	RANDOM
Zentner	Zentner	PART_OF
Klammer	Dame	RANDOM
Unverwundbarkeit	Verletzlichkeit	ANT
Degeneration	verarbeiten	HYPER
rationell	ineffizient	ANT
Gangster	Schulleiter	HYPER
entgangene	Weg	SYN
Pfund	Quartal	PART_OF
Ausländer	Reisende	HYPER
Heft	Dolch	PART_OF
beschäftigt	Scheren	RANDOM
Flegel	Klappe	HYPER
zufällig	bewusst	ANT
mutig	Kunststoff	RANDOM
Prozessor	Plattform	PART_OF
blass	draußen	RANDOM
Spanne	twosome	SYN
Strahl	Re	SYN
multilateral	einseitig	ANT
brauen	imprägnieren	HYPER
Lorbeer	koronalen	HYPER
Elend	sinnvoll	RANDOM
lernen	Pflanze	RANDOM
Boss	Zutat	RANDOM
Totschläger	Druck	SYN
Analog	analog	SYN
Runway	Transit	PART_OF
Metaphorik	Abbildungs	SYN
auslösen	Hebel	HYPER
künstlich	Synthetik	SYN
Balance	Halle	RANDOM
Alter	Lebenszeit	PART_OF
Zaun	Fechten	SYN
brüderlich	schwesterlich	ANT
Oregano	Oregano	PART_OF
Regal	Buffet	PART_OF
whitener	Ursache	HYPER
Arm	Reich	ANT
linear	nicht-lineare	ANT
Kredit	Lastschrift	ANT
Sicherheit	Unsicherheit	ANT
Hügel	Veranstaltung	RANDOM
Brief	Neu	RANDOM
Versammlung	Demontage	ANT
Ausschnitt	Sweatshirt	PART_OF
Bibliothek	Herstellung	RANDOM
berichtet	nicht gemeldet	ANT
bescheinigt	authentifiziert	SYN
eld	Lebenszeit	PART_OF
Reizung	Wundsein	SYN
befriedigend	ungenügend	ANT
Multikulturalismus	Nationalismus	ANT
ovipar	ovoviviparous	ANT
Snobismus	hauteur	HYPER
explizit	implizit	ANT
Schleier	Gebärmutter	PART_OF
wainwright	artificer	HYPER
Riff	Segel	PART_OF
pingelig	pingelig	SYN
Freund	seltsam	RANDOM
erledigt	durch	SYN
Deflation	Inflation	ANT
Hinweis	Tönung	SYN
Mitternacht	Nacht	PART_OF
Cent	rand	PART_OF
Ehe	eben	RANDOM
Orange	öffnen	RANDOM
Erzähler	Schwätzer	HYPER
Vorort	Franse	PART_OF
Unsicherheit	Sicherheit	ANT
Surfen	Surfbrett	SYN
Mitte	Insekt	RANDOM
Gamasche	tiff	SYN
Flüssigkeit	reinigen	RANDOM
Schaufel	Pfeil	PART_OF
hauchzart	schier	SYN
Schwefel	Auswirkung	HYPER
Köder	Trottel	SYN
familial	erblich	SYN
tötlich	verderblich	SYN
hacken	Kennzeichen	RANDOM
säumig	pokey	SYN
Backenzahn	molekular	ANT
einfach	unruhig	ANT
besetzt	unbemannt	ANT
Australien	Hand	RANDOM
zugewandt	Ärmel	PART_OF
Stichelei	Stichelei	SYN
unwissentlich	wittingly	ANT
Leere	Fülle	ANT
Bar	Öl	RANDOM
Amphotericin	Antibiotikum	HYPER
Fähigkeit	Unfähigkeit	ANT
Kopfschuss	pic	HYPER
Kapitel	Wolkenkratzer	RANDOM
respektlos	respektvoll	ANT
vergrößern	falsch informieren	HYPER
angenommen	Einheimische	ANT
Millimeter	Zentimeter	PART_OF
Rückgewinnung	Rettung	HYPER
Höflichkeit	Unhöflichkeit	ANT
wogenden	steigend	HYPER
Kreis	Bolzen	RANDOM
Funktion	Fehlfunktion	ANT
Lederhose	kurze Hose	HYPER
autonom	selbstständig	SYN
Fahnenstange	Fahnenmast	SYN
Meth	Shabu	SYN
Tierarzt	tierärztlich	SYN
abnormal	normal	ANT
Chaos	Flut	SYN
Stößel	Batterie	PART_OF
Mund	schwach	RANDOM
Schnurrhaare	Homo	PART_OF
Zahlen	Fliege	RANDOM
Rückhand	Vorhand	ANT
konventionell	unkonventionell	ANT
Gehirn	oben	RANDOM
Vorteil	heiraten	RANDOM
Leere	Vakanz	SYN
wunderbar	wondrously	SYN
Entscheidung	Unentschlossenheit	ANT
Masochist	Sadist	ANT
Stiefel	erstellen	RANDOM
Litschi	Litschi	PART_OF
Kugel	Region	HYPER
bewaffnet	unbewaffnet	ANT
Vermischung	Compoundierung	HYPER
Plündern	Raub	SYN
unterschätzen	konzipieren	HYPER
trinkbar	ungenießbar	ANT
Höhenflosse	Leitwerk	PART_OF
Kotzen	Kotzen	SYN
mieten	Kabel	RANDOM
Damm	Marmelade	HYPER
Bewohner	Bewohner	HYPER
Alibi	Verteidigung	HYPER
Pose	ärgern	SYN
Deckel	Geist	RANDOM
obdachlos	staatenlos	SYN
veg	Kraut	PART_OF
Kapitän	vertikal	RANDOM
frank	Ausrede	HYPER
Lebensunterhalt	Sein	HYPER
Querlatte	Torpfosten	PART_OF
wenig	Handel	RANDOM
Großrechner	Plattform	PART_OF
Stichel	schikanieren	HYPER
erscheinen	Film	RANDOM
Chiropraktiker	Experte	HYPER
Vorbeigehen	Laufen	ANT
Verfestigen	Plastination	PART_OF
Poller	Kai	PART_OF
Mittagessen	täuschen	RANDOM
Fahrrad	krank	RANDOM
Geburtstag	Gewehr	RANDOM
Kleidung	Ware	HYPER
brutto	Netz	ANT
Kies	Pose	SYN
Miliz	Reserve	SYN
sone	Phon	PART_OF
Edelmann	Edelfrau	ANT
roadbed	Route	PART_OF
Schild	Schaltier	PART_OF
Nichtraucher	Raucher	ANT
Kropf	Struma	SYN
Autor	Unterhaltung	RANDOM
Rallyes	Montage	HYPER
Favorit	bevorzugt	SYN
Treppe	Gebäude	PART_OF
Schlechtigkeit	Güte	ANT
Kinderarzt	medico	HYPER
bisexuell	heterosexuell	ANT
Förde	Mündung	HYPER
Zuhause	Stress	RANDOM
weitsichtig	kurzsichtig	ANT
reflektieren	Manifest	HYPER
gewöhnliche	Weiß	RANDOM
Messegelände	Traktat	HYPER
Schlafen	wachend	ANT
sumpfig	sumpfig	SYN
ungeduldig	geduldig	ANT
Haken	Zuschlag	SYN
Griffel	Patrone	PART_OF
gleichmäßig	ungleichmäßig	ANT
Flachland	Hochland-	ANT
Superstar	wiz	SYN
vorrücken	Rückzug	ANT
Ford	Strom	PART_OF
klebrig	geschmacklos	SYN
attributiv-	prädikativ	ANT
altklug	Verzögert	ANT
chon	gewonnen	PART_OF
schön	Universität	RANDOM
Östrogen	Östrogen	SYN
Treue	Gefolgschaft	SYN
Konformität	Nichteinhaltung	ANT
grimmig	Beize	SYN
Schaft	Wasserfahrzeug	PART_OF
naiv	anspruchsvoll	ANT
stickig	schwül	SYN
chromatisch	diatonischen	ANT
Salz-	bereit	HYPER
Broschüre	Mappe	SYN
doppelt	Karten	PART_OF
wahrscheinlich	jemand	HYPER
montieren	Tür	RANDOM
ovipar	viviparous	ANT
Yang	yin	ANT
Chromatin	Kern	PART_OF
matschig	seifig	SYN
Exposition	Fotografie	HYPER
beeindruckend	unscheinbar	ANT
Nation	ungewöhnlich	RANDOM
Sporn	Kleidung	HYPER
Portion	Profit	PART_OF
damit	Sol	SYN
blind	sehend	ANT
Flüssigkeit	Post	RANDOM
Karambolage	Schwimmbad	PART_OF
reizen	Auswirkung	HYPER
Kutikula	Weichtier	PART_OF
Kalb	Post	RANDOM
Schiene	Balustrade	PART_OF
Objekt	Konstellation	RANDOM
Burleske	Farce	SYN
Absicht	Absicht	SYN
Dorf	Gemeinde	SYN
fassen	kapieren	SYN
lingual	linguistisch	SYN
beweiskräftig	beweis	SYN
ausgestattet	unbestückt	ANT
neu beleben	neu erstellen	HYPER
Sturz	kippen	SYN
Mulltuch	Gaze	HYPER
Unmöglichkeit	Möglichkeit	ANT
dribbeln	tropfen	SYN
Nagetier	Säugetier-	HYPER
51	li	SYN
besudeln	verderben	SYN
Blau	Ignoranz	RANDOM
morph	verzerren	HYPER
cl	Deziliter	PART_OF
Beleuchtung	Ausrüstung	HYPER
mischen	Vermischung	SYN
Schalter	Änderung	HYPER
Japan	löschen	RANDOM
Führer	Strafverfolgung	RANDOM
Heckflosse	Dekoration	HYPER
allmählich	steil	ANT
Schließen	Öffnung	ANT
erfolgreich	vergeblich	ANT
Girlande	lei	SYN
buh	johlen	SYN
Cent	Bob	PART_OF
Hecke	ausweichen	SYN
Hintern	derriere	SYN
Abschreckungs	Anreiz	ANT
Ehe	Maus	RANDOM
Flotte	gehen	HYPER
disinclination	Neigung	ANT
Zähler	Domizil	PART_OF
Leck	Scheren	RANDOM
Marmelade	Bündel	SYN
Biege	Dame	RANDOM
fanatisch	übereifrig	SYN
Membran	Kamera	PART_OF
imprägnieren	Tinktur	SYN
abnehmend	Waxing	ANT
begründen	ändern	HYPER
Berg	Scheren	RANDOM
Arm	munition	PART_OF
Objektivität	Beurteilung	HYPER
Cannabis	Tour	RANDOM
Chance	Risiko	SYN
Ozean	Hobby	RANDOM
Verschwörer	Schulleiter	HYPER
Sehne	Muskulatur	PART_OF
Fortissimo	pianissimo	ANT
Acid	bitter	SYN
lernen	Brief	RANDOM
Kindes-	Eltern	ANT
abbrechen	Beendigung	HYPER
Bastard	illegitim	SYN
Unfall	Ende	RANDOM
verkörpern	in Worte fassen	HYPER
maximal	minimal	ANT
formalisierte	formalisierte	SYN
Drang	Rede	HYPER
Luft-zu-Luft-	Boden-Luft	ANT
cinque	Quintett	SYN
schwenken	Stapel	SYN
Trockenheit	Nässe	ANT
betrunken	Säufer	SYN
Alkohol	trinkbar	HYPER
Spur	standardisieren	HYPER
Trochanter	Femur	PART_OF
Mitarbeiter	Handlanger	SYN
Profanation	Sakrileg	SYN
Feld	Schüssel	PART_OF
schrecklich	horrend	SYN
Muskelmann	Angreifer	HYPER
Kessel	Dampfer	PART_OF
neu veröffentlichen	erneuern	HYPER
Bindehaut	Augenlid	PART_OF
Wohlwollen	Böswilligkeit	ANT
Zustimmung	Hahn	RANDOM
Nation	Schriftsteller	RANDOM
bedeuten	Show	RANDOM
verstopfen	Marmelade	HYPER
gebildet	ungeformt	ANT
Hügel	waschen	RANDOM
Pest	Zufügung	HYPER
verfrüht	Bisherige	SYN
buchsprachlich	fleißig	SYN
Kraft	Kraft	SYN
Einschnitt	Betrieb	PART_OF
Kilo	Kilogramm	SYN
mögen	Falle	RANDOM
Kammer	caput	PART_OF
schnelle Geschwindigkeit	hohe Geschwindigkeit	SYN
springen	Stich	RANDOM
Kreisel	Route	PART_OF
Vierer	Quartär	SYN
Geheimlehre	kabala	SYN
mischen	Leben	RANDOM
korrekt	falsch	ANT
billig	teuer	ANT
lenzen	Geschwindigkeit	HYPER
Neu	Recht	RANDOM
Klarheit	Dunkelheit	ANT
mieten	Neu	RANDOM
Hoffnung	Haus	RANDOM
günstig	ungünstig	ANT
Ration	Grenze	HYPER
Cannabis	Elend	RANDOM
Centavo	lempira	PART_OF
scheußlich	höllisch	SYN
Pint	picken	PART_OF
ansteigen	Studie	RANDOM
Haken	reiben	SYN
Schnupftabak	Konus	PART_OF
Rüstung	liefern	HYPER
misstrauisch	zutraulich	ANT
Pferd	Truppen	HYPER
anpassen	anpassen	SYN
vergangen	entgangene	SYN
Bibliothek	Linie	RANDOM
Jahr	Jahrhundert	PART_OF
Tipi	Wohnung	HYPER
Winter	Winter	PART_OF
Zentromer	Kern	PART_OF
gratis	unschmeichelhaft	ANT
Grabstein	Grab	PART_OF
Urheber	Schöpfer	HYPER
Alkohol	Rauschmittel	HYPER
Flanke	Vierfüßler	PART_OF
Blumenkrone	perianth	PART_OF
nonprofessional	Professionel	ANT
Blitz	abzischen	SYN
Kauen	Essen	PART_OF
Okular	Sehenswürdigkeiten	PART_OF
Schiene	Eisenbahn	PART_OF
Impressum	Mast	PART_OF
Baby	Wasser	RANDOM
verwüsten	Geißel	SYN
Prämisse	vermuten	HYPER
Kapuze	Flora	PART_OF
Bolzen	langsam	RANDOM
gabled	hipped	ANT
Mäander	Strom	PART_OF
Zischlaut	Reibelaut	HYPER
reheat	ändern	HYPER
glauben	konzipieren	SYN
Kanal	vermitteln	SYN
feige	ängstlich	SYN
begrenzt	unbegrenzt	ANT
Schädel	Tier	PART_OF
Debatte	gegenteilig	HYPER
Saloon	Kneipe	PART_OF
Unfall	Fisch	RANDOM
unmoralisch	Moral-	ANT
stickig	schweflig	SYN
heterogen	homogene	ANT
kauen	waschen	RANDOM
perfekt	Maus	RANDOM
Verantwortungslosigkeit	Verantwortung	ANT
kohärent	inkohärent	ANT
Loch	Dichtung	RANDOM
Eierstock	Angiospermen	PART_OF
Repellent	yucky	SYN
konservativ	Liberale	ANT
Vorläufer	Vorgänger	SYN
unausweichlich	unvermeidlich	SYN
ischium	Schenkel	PART_OF
Christian	singen	RANDOM
Landung	Einschiffung	ANT
Verteidigung	offensiv	ANT
Zentner	Tonne	PART_OF
aufeinanderfolgenden	aufeinanderfolgende	SYN
Aktivität	Inaktivität	ANT
geplanter Termin	Vermittlung	HYPER
Gemeinde	Kreis	HYPER
lernen	Schlecht	RANDOM
Schlüssel	enorm	RANDOM
Sündenbock	Saugnapf	SYN
fähig	fähig	SYN
Schreiben	Aktivität	HYPER
saftig	glühend	SYN
Sanierungs	therapeutisch	SYN
Persönlichkeit	jemand	PART_OF
Grabstein	Kolonnade	PART_OF
nettlesome	Belästigung	SYN
unzulässige	zulässig	ANT
Ausrufer	Hausierer	HYPER
Hafen	Schild	SYN
Pferdefleisch	Pferd	PART_OF
ansprechend	unansehnlich	ANT
Tüll	Mesh	HYPER
Ecke	Gebäude	PART_OF
Angstrom	Nanometer	PART_OF
bemusement	Mystifikation	SYN
komponieren	bilden	HYPER
Scherer	Arbeiter	HYPER
Insuffizienz	Hinlänglichkeit	ANT
Überlagerungs	mischen	HYPER
Gelegenheit	Auftreten	HYPER
Vorwort	Veröffentlichung	PART_OF
Dreh dich um	Route	PART_OF
impressment	Aneignung	HYPER
Zyklus	Kilohertz	PART_OF
irregulär	regulär	ANT
maven	Sensation	SYN
Taste	Süss	RANDOM
Fender	Motor	PART_OF
Schlüssel	verunreinigen	RANDOM
Centavo	cordoba	PART_OF
schlechtes Benehmen	Fehlverhalten	HYPER
Entzündung	Anzündholz	SYN
Ablauf	Atmung	PART_OF
Schlampe	Gebärmutterhals	PART_OF
Triade	Anhäufung	HYPER
feminin	männlich	ANT
knapp	kaum	SYN
bewerten	messen	SYN
Divination	vermuten	HYPER
Säugetier	ziehen	RANDOM
graben	Macht	HYPER
Angriff	Ansturm	PART_OF
besonders	Universal-	ANT
Gangsterbraut	Schulleiter	HYPER
Sprache	Pfanne	RANDOM
Bedingung	verarbeiten	HYPER
ascendency	Herrschaft	SYN
Königtum	Zahlung	HYPER
gewissenhaft	skrupellos	ANT
Monitor	mögen	RANDOM
Gondel	Luftschiff	PART_OF
direkt	indirekt	ANT
Joggen	Lüge	RANDOM
Verbot	benötigen	HYPER
Ausweichen	Falschheit	HYPER
Phase	Rhythmus	PART_OF
erzeugen	laichen	SYN
Unsichtbarkeit	Sichtweite	ANT
Fleisch fressend	pflanzenfress	ANT
pendent	Halskette	PART_OF
fähig	unfähig	ANT
Betrüger	Übeltäter	HYPER
Stadt	Material	RANDOM
Ampulle	Kanal	PART_OF
Schauer	Nervenkitzel	SYN
Angemessenheit	Unzulänglichkeit	ANT
Unabhängigkeit	Muskel	RANDOM
Konservatorium	Gebäude	HYPER
häufig	selten	ANT
schwimmend	gestrandet	ANT
Pfand	Assistent	HYPER
knallig	sportlich	SYN
Anruf	Unterhose	RANDOM
Meisterschaft	Titel	SYN
Aggressor	Anstifter	HYPER
Schild	Quartal	PART_OF
unwissentlich	witting	ANT
Bourgeois	konservativ	SYN
Calamari	Tintenfisch	PART_OF
Inkubation	Zeitraum	HYPER
fleckig	makellos	ANT
Schleier	Gebärmutter	PART_OF
Kanarienvogel	Sänger	HYPER
schwindsüchtig	generativ	ANT
Kontinuität	Diskontinuität	ANT
betrügen	Container	RANDOM
rege	Tracht Prügel	SYN
behindert	ungehindert	ANT
Objekt	Tor	RANDOM
standhalten	kämpfen	HYPER
schwappen	streuen	HYPER
Negativ	neutral	ANT
geächteten	verboten	SYN
ereignisreich	ereignislos	ANT
beschränkt	uneingeschränkt	ANT
fördern	ernennen	HYPER
Versuchen	Sonde	HYPER
Kunstwerk	Veröffentlichung	PART_OF
hoagie	Keil	SYN
Bewegung	Fußboden	RANDOM
Bildbeschriftung	Ausführung	HYPER
Schnabel	überlegen	RANDOM
superego	bewusstlos	PART_OF
Überschneidung	Beitritt	HYPER
Anerkennung	Botschaft	HYPER
Anspruchsvoll	anspruchslos	ANT
erleichtern	jubeln	HYPER
orthodox	unorthodox	ANT
zweijährig	beständig	ANT
lernen	Gefühl	RANDOM
verdammt	verwirrt	SYN
Anerkennung	Abschreibung	ANT
blühen	Information	RANDOM
Gravitation	Schweben	ANT
Beachtung	Nichteinhaltung	ANT
Heldentum	Tapferkeit	SYN
Neu	Müll	RANDOM
pubis	Becken	PART_OF
unehrenhaft	ehrbar	ANT
Megabit	Gigabit	PART_OF
unpräzise	genau	ANT
betrügen	Reproduktion	RANDOM
zurückhaltend	hemmungslos	ANT
Arm	Waffen	PART_OF
zeremoniell	rituell	SYN
aufsteigend	absteigend	ANT
Fünfkämpfer	Kandidat	HYPER
Kochen	führen	RANDOM
kristallin	klar	SYN
Schankstube	Saloon	PART_OF
Favorit	Wahl	HYPER
perfekt	bringen	RANDOM
in erster Linie	hauptsächlich	SYN
sinnvoll	bedeutungslos	ANT
Treue	Untreue	ANT
aussehen	Transport	RANDOM
Zusammenschluss	Vereinigung	HYPER
Gitter	Herd	PART_OF
Vorrat	Akkumulation	HYPER
Gallone	Scheffel	PART_OF
bequem	unangenehm	ANT
Körperbau	jemand	PART_OF
Organ	Detail	RANDOM
Pedal	Zyklus	PART_OF
Schicksal	übernatürlich	PART_OF
Knoten	Darsteller	RANDOM
chela	Krebs	PART_OF
Dressing	Düngung	SYN
Zuweisung	Zuteilung	SYN
Konformist	Nonkonformist	ANT
Mark	o	PART_OF
Unterbrechung	Golf	SYN
Sättigung	Plastination	PART_OF
Unparteilichkeit	Parteilichkeit	ANT
geschützt	ungeschützt	ANT
Schmiede	Fortschritt	HYPER
Mikrosekunde	s	PART_OF
unheilig	böse	SYN
Schnabel	Stadt	RANDOM
misfeasance	Fehlverhalten	HYPER
mutwillig	trödeln	HYPER
Badende	Ursache	HYPER
Menschheit	Ergebnis	RANDOM
hacken	Erwachen	RANDOM
Dualität	Anordnung	HYPER
Park	Süss	RANDOM
flimflam	Gedränge	SYN
Athlet	Idee	RANDOM
Fragen	erfordern	SYN
Gammler	Torso	PART_OF
Konjugation	Kreuzung	SYN
Konföderation	Verschwörung	SYN
Kreuzung	Wasserlauf	PART_OF
Zusammensetzung	Verfassung	SYN
kopflos	erschrocken	SYN
unwillkommen	herzlich willkommen	ANT
Müdigkeit	Müdigkeit	SYN
Basketball	Mais	RANDOM
Hüfte	Hüfte	PART_OF
Wimper	optisch	PART_OF
Mosaik-	Kamera	PART_OF
verletzen	Löschen	RANDOM
Rindfleisch	Wagen	RANDOM
Aggressivität	Feindschaft	HYPER
sechziger Jahre	eld	PART_OF
ligne	im	PART_OF
Heft	stehlen	PART_OF
Objekt	füllen	RANDOM
gleichermaßen	ungleichmäßig	ANT
Neurologe	Spezialist	HYPER
Rotor	Gebläse	PART_OF
Planke	Plattform	PART_OF
freundlich	liebenswürdig	SYN
Hornhaut	optisch	PART_OF
unter der Woche	Woche	PART_OF
Blesse	Auftreten	HYPER
Geburt	Bauernhof	RANDOM
beschäftigt	einfach	RANDOM
drosseln	Flugzeug	PART_OF
hokey	gestelzt	SYN
Falte	Biege	SYN
Rückhalt	die Genehmigung	HYPER
fiktiv	vorgab	SYN
Auto	Vergnügen	RANDOM
Verarmung	Entbehrung	HYPER
Partituren	Stapeln	SYN
kastanienbraun	Strand	SYN
Stütze	Rahmen	PART_OF
locken	einladen	HYPER
jugendlich	Teenager	SYN
Irland	Mais	RANDOM
Leichtigkeit	Ruhe	SYN
jawed	jawless	ANT
Mehrheit	Minderheit	ANT
Netz	Gebärmutter	PART_OF
Tastatur	Krug	RANDOM
Wirksamkeit	Ineffizienz	ANT
Ersatz	Ersetzung	SYN
männlich	kastrieren	ANT
Minute	Lüge	RANDOM
Lautstärke	Weichheit	ANT
degenerieren	fallen	SYN
Penis	Seele	RANDOM
römisch	Quelle	HYPER
lautlos	immer noch	SYN
Fahrrad	Ignoranz	RANDOM
schlagen	Ozean	RANDOM
Vergangenheit	Design	RANDOM
Gleichheit	Invarianz	HYPER
halbes Jahrhundert	Jahrhundert	PART_OF
Frachter	Handelsschiff	SYN
paisa	Rupie	PART_OF
Ballaststoff	jemand	PART_OF
Gitter	Herd	PART_OF
Eisbrecher	Wasserfahrzeug	HYPER
Stirn	caput	PART_OF
Ablehnen	Verbesserung	ANT
Zentimeter	Meter	PART_OF
Anzeige	Werbung	SYN
hell	reifen	RANDOM
Anstand	Unanständigkeit	ANT
hinter	Torso	PART_OF
Strudel	Wirbel	SYN
Zentralisierung	Dezentralisierung	ANT
Wettbewerbsfähigkeit	Aggressivität	HYPER
Ausfall	Unternehmen	HYPER
zärtlich	zäh	ANT
Halbmond	Jahr	PART_OF
sr	Kugel	PART_OF
lang	ausgedehnt	SYN
Mäßigung	Ereignis	HYPER
hinzufügen	Wasserfall	RANDOM
beheben	Konvertieren	HYPER
Einbildung	Demut	ANT
Luke	Öffnung	PART_OF
berechtigt	untauglich	ANT
pinger	Unter	PART_OF
heilen	Behandlung	PART_OF
im Uhrzeigersinn	gegen Uhrzeigersinn	ANT
Nadir	Zenit	ANT
streaker	jemand	HYPER
kürzen	gekürzt	SYN
Anfrage	Verhör	SYN
Keramiker	Werfer	SYN
Landung	Hafen	PART_OF
Schleich	Kitz	SYN
ausspeien	Schuppen	SYN
Abschweifung	Umleitung	SYN
Homosexuelle	ein	RANDOM
Brust	Torso	PART_OF
Untätigkeit	Leichtigkeit	HYPER
Klitoris	Vulva	PART_OF
Achtelmeile	Liga	PART_OF
Demut	Beitreten	RANDOM
ab	Bauch	PART_OF
Wecken	Signalisierung	HYPER
Kind	Party	RANDOM
alt	schick	RANDOM
Kern	Punkt	RANDOM
Irrelevanz	Relevanz	ANT
Samba	meld	HYPER
zaubern	rühren	SYN
sphenoid	caput	PART_OF
herrschsüchtig	fügsam	ANT
mutig	Nachwuchs	RANDOM
ungestüm	wegreißen	SYN
düster	schmutzig	SYN
illegitim	verbotenerweise	SYN
Stabilisator	Rumpf	PART_OF
Nominativ	schräg	ANT
Wange	Torso	PART_OF
Korb	gebunden	HYPER
wert	Wertlosigkeit	ANT
Ananas	Ananas	PART_OF
Badezimmer	erhöhen	RANDOM
Zugänglichkeit	Unzugänglichkeit	ANT
urinieren	Freisetzung	HYPER
Hilfe	wollen	RANDOM
Tensor	Variable	HYPER
docent	Erzieher	HYPER
Gang	Hass	RANDOM
unverantwortlich	verantwortlich	ANT
Fahrbahn	Schnellstraße	PART_OF
unehrenhaft	ehrenvoll	ANT
Eingangsstufe	Schwelle	PART_OF
spitz	zwecklos	ANT
Kick	verzichten	HYPER
hoch	Antizyklon	PART_OF
Menschheit	Aufklärung	RANDOM
Messing-	Regierung	PART_OF
Christian	kurz	RANDOM
Klugheit	Überlegenheit	HYPER
Krankenhausaufenthalt	Status	HYPER
Klammer	Zeit	RANDOM
Bulimie	verärgert	HYPER
lat	Torso	PART_OF
Prozentsatz	Profit	PART_OF
Eishockey	machen	RANDOM
vermuten	Richter	SYN
Monitor	fließen	RANDOM
Uhr	beschränken	RANDOM
Maschine	Verbreitung	RANDOM
Balance	Buchhaltung	PART_OF
Vagina	Arsch	PART_OF
Lärm	verbinden	RANDOM
Vertrag abgeschlossen	ergänzt	ANT
Schnitzer	flub	SYN
Kinn	caput	PART_OF
Zeitraum	Epoche	PART_OF
Stärke	die Schwäche	ANT
Zuhause	ausführen	RANDOM
Japan	Stich	RANDOM
Organ	Fenster	RANDOM
Umständlichkeit	Reizbarkeit	SYN
Schwall	Haufen	HYPER
Blick	Aspekt	HYPER
Ausrüstung	halb	SYN
pentacle	pentangle	SYN
Speichel	Humor	HYPER
Scharnier	Gebäude	PART_OF
Entmutigung	Förderung	ANT
mines	Zeche	PART_OF
Schönheit	Pop	RANDOM
Taste	Größe	RANDOM
scape	Säule	PART_OF
Kohl	Kohl	PART_OF
Öse	drapierung	PART_OF
Ausschluss	Aufnahme	ANT
liniert	ungefüttert	ANT
barmherzig	gnadenlos	ANT
Milch	Zukunft	RANDOM
Balance	Molekül	RANDOM
Kopfhaut	Transfer	HYPER
fain	gern	SYN
Leichenschauhaus	Gebäude	HYPER
Trümmer	Schutt	SYN
Grundpfeiler	Kolonnade	PART_OF
helianthus	Sonnenblume	SYN
auspowern	berauben	HYPER
Glauben	seltsam	RANDOM
Antworten	Feindseligkeit	RANDOM
männlich	Null	RANDOM
Phantasie	Konstellation	RANDOM
Verzauberung	buchstabieren	SYN
Glühfaden	Birne	PART_OF
Folklore	Überlieferung	HYPER
Schwimmbad	Vorrat	HYPER
zugewandt	Hals	PART_OF
Bewaldung	Umwandlung	HYPER
Hamburger	Sandwich	HYPER
Frieden	Tour	RANDOM
Krebs	Verknüpfung	RANDOM
Zahnbürste	Schnurrbart	HYPER
Mogul	Magnat	SYN
Perversion	Aktivität	HYPER
beleuchtet	unbeleuchteten	ANT
mild	unbarmherzig	ANT
endothermisch	exotherme	ANT
obligate	Schreiben	HYPER
hacken	engagieren	RANDOM
Beratung	Lenkung	SYN
Flugplatz	Feld	SYN
Schaden	Verletzung	SYN
Schädel	Schädel	PART_OF
Schwefel	Auswirkung	HYPER
Behälter	Zauber	RANDOM
Insasse	stationäre	SYN
Missverhältnis	Anteil	ANT
Antragsteller	litigator	HYPER
Kommode	Wohnen	PART_OF
optisch	Homo	PART_OF
Optimistin	Pessimist	ANT
überlisten	übertrumpfen	HYPER
aufsteigen	persönlich	RANDOM
glücklicherweise	Unglücklicherweise	ANT
Zuschauer	Zeuge	SYN
achtziger Jahre	Jahre	PART_OF
lyrisch	Münze	RANDOM
Induktion	Beachtung	HYPER
Hierarchie	Regierung	PART_OF
Corona	perianth	PART_OF
Langeweile	böse	RANDOM
Subkultur	Zivilisation	PART_OF
Arithmetik	Konstellation	RANDOM
Fehler	Star	RANDOM
klassifiziert	nicht klassifiziert	ANT
FALSCH	WAHR	ANT
glabella	Schädel	PART_OF
Stümperei	ungeschickt	SYN
Schlag	Sieg	RANDOM
Verletzung	Missgeschick	HYPER
drei	Troika	SYN
Nacht-	Katze	RANDOM
Gondel	Luftschiff	PART_OF
Anker	Obus	PART_OF
abgespannt	getragen	SYN
Sackgasse	still stehen	SYN
dag	Kilogramm	PART_OF
stridency	Timbre	HYPER
Dezibel	Einheit	HYPER
nontechnical	technisch	ANT
Streit	tiff	SYN
Hinweis	Regen	RANDOM
Überhand	hinterhältig	ANT
Schwäche	Gebrechlichkeit	SYN
knurrend	Stimmgebung	HYPER
Raumfahrer	Raumfahrer	SYN
permanent	vorübergehend	ANT
Beitreten	Schuh	RANDOM
Blumenkrone	blühen	PART_OF
Bisamratte	Nagetier	HYPER
herausfordernd	faszinierend	SYN
reinigen	der Ekel	RANDOM
Hinterteil	Vierfüßler	PART_OF
Nachzügler	Faulenzer	HYPER
Tierkreis	Diagramm	HYPER
kb	Gigabit	PART_OF
Pleite	nonstarter	HYPER
Verkehr	Verbreitung	HYPER
unlogisch	logisch	ANT
lyrisch	Zimmer	RANDOM
Menschenfeind	grump	HYPER
vertrauenswürdig	unseriös	ANT
gefingert	fingerless	ANT
Intonation	Anmeldung	HYPER
pingelig	besonders	SYN
pilus	Säugetier-	PART_OF
Ratte	Polsterung	HYPER
pes	Homo	PART_OF
weihen	erklären	HYPER
Zeichner	Künstler	HYPER
Dekontamination	Entfernung	HYPER
Landsmann	Gegenstand	HYPER
reinigen	Ideologie	RANDOM
winken	interagieren	HYPER
ersichtlich	offensichtlich	SYN
Roggen	Roggen	PART_OF
Mississippi	klingen	RANDOM
masochistisch	sadistisch	ANT
Decke	erfüllen	RANDOM
Verschluss	Fass	PART_OF
Gläubiger	Schuldner	ANT
sechsundvierzig	XLVI	SYN
Sandwich	Mahl	PART_OF
Ast	Stoff	RANDOM
Milbe	Fleck	SYN
Bedeutung	habe gedacht	HYPER
Resultante	Variable	HYPER
übermäßig	auch	SYN
Jab	Sack	SYN
Erhöhung	Kugel	PART_OF
Sektion	Chirurgie	PART_OF
Konsistenz	Unbeständigkeit	ANT
übereinstimmend	Konsonant	SYN
emulieren	imitieren	HYPER
Orbit	Umfang	HYPER
Empfangshalle	reinigen	RANDOM
wohlerzogen	gesittet	SYN
Basar	Messe	SYN
Babysitter	biddy	HYPER
maxwell	weber	PART_OF
chou	Gemüse	HYPER
Lappen	necken	SYN
Schiebedach	Auto	PART_OF
Pflege	erscheinen	RANDOM
ringen	Erwägen	HYPER
billig	autorisieren	HYPER
Dock	Seehafen	PART_OF
Depressiva	stimulative	ANT
Garnele	Garnele	PART_OF
Zentner	kiloton	PART_OF
Karosserie	Geschichte	RANDOM
Stil	blühen	PART_OF
abgeneigt	widerstrebend	SYN
aufsteigen	West-	RANDOM
Sprunggelenk	Huftier-	PART_OF
Flotte	Geschwindigkeit	HYPER
allmählich	plötzlich	ANT
gurgeln	Ereignis	HYPER
entrechtet	enfranchised	ANT
Thunfisch	tunny	PART_OF
Wasser	Bank	HYPER
rekombinieren	ändern	HYPER
emotional	unbewegt	ANT
Hellseher	präkognitive	SYN
überdachte	ohne Dach	ANT
gastfreundlich	unwirtlich	ANT
Ozean	Strafverfolgung	RANDOM
aufmerksam	unaufmerksam	ANT
Lager	Montage	HYPER
Bit	hören	RANDOM
Chuzpe	Frechheit	HYPER
personifizieren	zuschreiben	HYPER
wieder einbringen	zurückhalten	SYN
Veränderung	Geschmack	RANDOM
Mittel	Umgebung	HYPER
Haus	Mond	RANDOM
Attraktion	Abstoßung	ANT
bestehen	Gras	RANDOM
Kern	Freundin	RANDOM
China	Kabel	RANDOM
missachten	Rabatt	HYPER
Schlepper	Betätigung	HYPER
abheben	aufhören	HYPER
Strudel	Strom	HYPER
Bibliothek	Planet	RANDOM
Ehrlichkeit	Ende	RANDOM
Förder	Fabrik	PART_OF
Allgemeines	Spezifisch	ANT
Kontraktion	Erweiterung	ANT
Kandelaber	Halter	HYPER
Mitte	Zehe	RANDOM
Maus	Streifen	RANDOM
Kot	Ausscheidung	HYPER
Ernte	Anhäufung	HYPER
Eigelb	Eier	PART_OF
Teil	Meer	RANDOM
Tier	großzügig	RANDOM
Zelt	Hütte	HYPER
Schwall	Tide	SYN
Treppe	Gebäude	PART_OF
tugendhaft	böse	ANT
sichern	begleiten	HYPER
Inhaltsangabe	wiederholen	HYPER
mickle	Floß	SYN
Rechnung	Gerechtigkeit	RANDOM
Vulkanologie	Geophysik	HYPER
Gläubiger	Schuldner	ANT
Windel	Kleidungsstück	HYPER
Untersuchung	testen	SYN
dogfight	Engagement	HYPER
herpetologist	Zoologe	HYPER
Höhepunkt	Perigäum	ANT
Mittagessen	Kommunikation	RANDOM
mi	Meile	SYN
Garn	rezitieren	HYPER
Indizierung	Gruppierung	HYPER
Estragon	Estragon	PART_OF
nett	saugen	RANDOM
shillelagh	Knüppel	HYPER
Haus	unbekannte	RANDOM
Mord	Prüfung	RANDOM
Vorsitzende	Vorsitzende	SYN
knotig	knorrigen	SYN
Kiefer	Homo	PART_OF
faul	bringen	RANDOM
human	inhuman	ANT
Streit	Uneinigkeit	HYPER
Finder	gunsight	PART_OF
capstone	Gebäude	PART_OF
Rindfleisch	Aufklärung	RANDOM
Rist	Ochse	PART_OF
Gurke	Gurke	PART_OF
Einspruch	Wahl	HYPER
Postleitzahl	Ziel	PART_OF
Heuboden	mähen	SYN
sympathisch	unsympathisch	ANT
Zaum	beschränken	HYPER
Kissen	Schicht	HYPER
endemisch	Epidemie	ANT
Kamerad	sehen	RANDOM
Entschädigung	Restitution	SYN
Endometrium	Gebärmutter	PART_OF
Klein	Groß	ANT
Professionel	unprofessionell	ANT
verleihen	äußern	HYPER
Plumps	Schlag	SYN
Firn	Gletscher	PART_OF
Brief	nicht gefallen	RANDOM
Aktion	Saum	RANDOM
glücklich	unglücklich	ANT
Angemessenheit	Unangemessenheit	ANT
Denken	habe gedacht	SYN
Aufstauung	Internierung	SYN
Büschel	Auftreten	HYPER
Genesis	Ereignis	HYPER
Leserschaft	Publikum	HYPER
Radius	Wagen	PART_OF
Konzentration	Verdünnung	ANT
trauernde	bereft	SYN
neigen	helfen	HYPER
glatt	listig	SYN
Chicha	shisha	SYN
Kette	Unterhose	RANDOM
gründlich	durchgreif	SYN
tauchen	graben	SYN
Leben	Tabelle	RANDOM
häufig	oft	SYN
Berghang	montieren	PART_OF
blühen	Empfangshalle	RANDOM
schwarz	Landschaft	RANDOM
verrückt machen	Lappen	HYPER
einschüchtern	erregen	HYPER
Hammer	Tympanum	PART_OF
fraglich	unbestreitbar	ANT
Glauben	Interesse	RANDOM
Seelenverwandtschaft	Freundlichkeit	HYPER
blühen	Handel	RANDOM
Bunker	Toque	SYN
Welle	Zeiger	PART_OF
Aspiration	Atmung	PART_OF
machen	beenden	HYPER
grad	Klasse	SYN
Sattelauflieger	Ausrüstung	PART_OF
locken	Fragen	HYPER
Mythologie	Anhäufung	HYPER
kann	Aufenthalt	PART_OF
vierundsechzigsten	Fraktion	HYPER
Bild	Schwert	RANDOM
saisonal	das ganze Jahr	ANT
Durian	Durian	PART_OF
Förder	Mühle	PART_OF
bewundern	Buch	RANDOM
Pulk	Falte	HYPER
Stierkämpfer	Toreador	SYN
varmint	jemand	HYPER
Zufluss	Abfluss	ANT
Neigung	Elevation	PART_OF
turnieren	Turnier	PART_OF
Karat	gm	PART_OF
Darsteller	Saum	RANDOM
Penis	Horn	RANDOM
Scoop	ausbaggern	PART_OF
Brustbein	Torso	PART_OF
Manöver	Manöver	SYN
erkennbar	unmerklich	ANT
Orthopädie	Orthopädie	SYN
Mikron	cm	PART_OF
tot	Leben	ANT
Artillerie	Batterie	PART_OF
Ansatz	Monokel	RANDOM
quoin	Gebäude	PART_OF
Arteriosklerose	Pathologie	HYPER
Druck	Betätigung	HYPER
Luft	Deckel	RANDOM
untere Schicht	Mittelklasse	ANT
Wachsamkeit	Wachsamkeit	SYN
Knochen	Schatten	RANDOM
vorausgehen	gehen	HYPER
Großzügigkeit	Geiz	ANT
schwerfällig	ungeschickt	SYN
nonresidential	Wohn	ANT
mehrfarbig	mehrfarbig	SYN
Organisation	Regierung	PART_OF
Hostess	Gastwirt	HYPER
Farbe	Teil	RANDOM
Millimeter	Zentimeter	PART_OF
beschneiden	trimmen	HYPER
Trocknung	Plastination	PART_OF
Gerangel	gehen	HYPER
stürmisch	wild	SYN
Box	beschäftigt	RANDOM
Masochist	Sadist	ANT
eindeutig	unbestimmt	ANT
Prädiktor	Flakfeuer	PART_OF
Garnierung	verschönern	HYPER
Majoran	Oregano	PART_OF
Zuneigung	Ideologie	RANDOM
am wenigsten	die meisten	ANT
kreuzigen	Teufel	HYPER
geringer	tyke	SYN
Grabstein	Grab	PART_OF
zuvorkommend	unbeschwert	SYN
abzulassen	trimmen	HYPER
Rollkragen	Jumper	HYPER
Schwere	Leichtigkeit	ANT
Spule	Dreh	SYN
bezaubernd	packend	SYN
Tadel	kritisieren	HYPER
Mehrheit	Erwachsensein	PART_OF
ehebrecherisch	außerehelich	SYN
Lager	Heraldik	HYPER
Drift	Überschrift	SYN
Anreißer	Hündchen	SYN
kompensiert	stipendiary	SYN
erweitern	beeinflussen	HYPER
Gräueltat	Barbarei	SYN
Segel	fegen	SYN
verlieren	Dokument	RANDOM
Morgen	Jenseits	HYPER
zerstörbar	unzerstörbar	ANT
Sauropoden	Dinosaurier	HYPER
Innereien	Geflügel	PART_OF
nett	Rang	RANDOM
ungerecht	ungerecht	SYN
Massiv	Angebot	PART_OF
Bewegung	Vater	RANDOM
Regal	Anrichte	PART_OF
Tortilla	wickeln	PART_OF
Hausaufgaben	Lehren	PART_OF
Narkose	Narkose	SYN
ft	lea	PART_OF
unehrlich	ehrlich	ANT
allmächtig	allmächtig	SYN
Brust	Thorax	PART_OF
Schaft	Schläger	PART_OF
Ventil	Pumpe	PART_OF
Minute	Tor	RANDOM
Umstand	Rahmen	SYN
Karte	Karton	HYPER
Ziel	Korrespondenz	PART_OF
Anode	Kathode	ANT
Pädagoge	educationist	SYN
Furche	Impressum	HYPER
Unterbau	Struktur	PART_OF
Absicht	Bedeutung	HYPER
Rotor	glattere	PART_OF
hauen	Schimmel	HYPER
Gebrüll	Aufschrei der Empörung	HYPER
besiegt	unbesiegt	ANT
Melamin	Alkali	HYPER
Kollision	Uneinigkeit	HYPER
taktvoll	taktlos	ANT
Souffleur	Fan	HYPER
Hahnenfuß	Kraut	HYPER
Scheffel	cwt	PART_OF
Stiefel	Kamin	RANDOM
Hang	Hügel	PART_OF
rechtmäßig	erlaubt	SYN
Liste	Neigung	HYPER
con	Profi	ANT
cps	kc	PART_OF
Trommelfell	caput	PART_OF
Elevation	Höhe	SYN
Unterschrift	Weise	HYPER
Elend	Schritt	RANDOM
bestehen	unbekannte	RANDOM
Steigbügel	Tympanum	PART_OF
funktional	verwendbar	SYN
Trümmer	Trödel	SYN
Brust	Wirbeltier	PART_OF
Lenkung	Seefahrt	PART_OF
braincase	Knochen	HYPER
tauchen	Neigung	SYN
Höcker	Pumpe	PART_OF
Anti	Profi	ANT
aushändigen	Verzicht	HYPER
schusseln	stolpern	SYN
Jack	Schüsseln	PART_OF
männlich	Menge	RANDOM
Tweed	Weiß	SYN
binden	Fernseher	RANDOM
Hoffnung	Verlangen	HYPER
Befehl	übersehen	SYN
congress	Gesetzgeber	HYPER
multitudinous	ohne Nummer	SYN
Vorder-	hintere	ANT
anorganisch	organisch	ANT
Schall-	Unterschall	ANT
Australien	Ehefrau	RANDOM
Keller	waschen	RANDOM
Plazenta	blühen	PART_OF
Nonkonformist	recusant	SYN
Jet	Kurs	HYPER
pica	ft	PART_OF
Verwaltung	Regime	PART_OF
Verteidigung	Delikt	ANT
Grosz	Zloty	PART_OF
Promenade	Trupp	SYN
Dolle	dory	PART_OF
untere Schicht	Oberschicht	ANT
hüpfen	denken	RANDOM
Pflaume	Pflaume	PART_OF
Fingernagel	manus	PART_OF
Geschwister	Beziehung	HYPER
inländisch	fremd	ANT
Fleisch	Bühne	RANDOM
Schnecke	Labyrinth	PART_OF
zwanziger Jahre	Reife	PART_OF
Blüte	Blütenstand	SYN
entziffern	entschlüsseln	SYN
Bedeutungslosigkeit	Bedeutung	ANT
Dekrement	Zuwachs	ANT
Fleisch	Scheren	RANDOM
Amygdala	Pallium	PART_OF
Wippe	Artefakt	HYPER
Unterarm	Homo	PART_OF
pallidum	Striatum	PART_OF
Seebrücke	Gebäude	PART_OF
Popanz	Flugzeug	HYPER
Maniok	gari	PART_OF
nahtlos	ungefüttert	SYN
Knochen	stechen	RANDOM
Augenbraue	caput	PART_OF
Dendriten	Neuron	PART_OF
Eishockey	Fix	RANDOM
erforderlich	erforderlich	SYN
religiös	weltlich	ANT
Vortäuschung	heuchlerischen	HYPER
Auffassung	bekommen	HYPER
Morgen	bräunen	RANDOM
institutionalisierte	institutionalisierte	SYN
Party	Jacke	RANDOM
Flotte	Atemwegs	PART_OF
Glücklicherweise	unglücklicherweise	ANT
Anreißer	Promoter	HYPER
Bündnis	erklären	HYPER
Hals	Werkzeug	RANDOM
Membran	präventiv	HYPER
Cut-up	hoaxer	SYN
auffindbar	unauffindbar	ANT
Verband	Verfremdung	ANT
reorganisieren	Befehl	HYPER
Spezialität	Besonderheit	SYN
harmlos	schädlich	ANT
Nachrichten	Haut	RANDOM
Klarheit	Opazität	ANT
Schiffswrack	zuvorkommen	HYPER
Schlepper	Abschleppen	HYPER
Schließe	Armreif	PART_OF
Stil	Stempel	PART_OF
Zehnte	Transfer	HYPER
Linie	Lachen	RANDOM
Mitte	Schwanz	RANDOM
Geburtstag	Geschäft	RANDOM
laut	Traurigkeit	RANDOM
Jobber	Mittelsmann	SYN
Knoten	Planke	PART_OF
Verbrauchssteuer	kratzen	SYN
geruchlos	duftend	ANT
Kochen	Trennung	RANDOM
Vororte	outskirt	PART_OF
Maiskolben	Mais	PART_OF
Wunsch	äußern	HYPER
Windschutzscheibe	Flugzeug	PART_OF
Elektrode	Tube	PART_OF
nett	Wissenschaft	RANDOM
Clown	Scherz	HYPER
unter Druck setzen	aufladen	SYN
Schönheit	Bürste	RANDOM
Täter	Übeltäter	SYN
Brust	erreichen	HYPER
Minister	abgestanden	RANDOM
ansteckend	Tat	HYPER
Name	einzeln aufführen	HYPER
alphabetisches Ortsverzeichnis	Atlas	PART_OF
übergreifen	Fortschritt	HYPER
multitudinous	Myriade	SYN
Faktor	verleihen	HYPER
Feier	Jubel	SYN
Empfangshalle	Mensch	RANDOM
Orchester	Theater	PART_OF
Schlacht	Post	RANDOM
Pedal	Strafverfolgung	RANDOM
reichlich	knapp	ANT
betrügen	Brief	RANDOM
Dicke	Dünnheit	ANT
mythischen	mythisch	SYN
gutartig	maligne	ANT
Dame	Werkzeug	RANDOM
Elternteil	perfekt	RANDOM
Vorratskammer	Esslokal	HYPER
Mississippi	sparen	RANDOM
Erwachsene	Dichtung	RANDOM
Maniok	Maniok	PART_OF
transparent	transparent	SYN
Juwel	Schmuck	PART_OF
stachelte	Lob	HYPER
Notlage	versichern	HYPER
Grapefruit	Zitrusgewächs	HYPER
Mittagessen	tiffin	SYN
Fledermäuse	durchgedreht	SYN
jeden Tag	alltäglich	SYN
Versicherer	Versicherer	SYN
Fessel	Vorhängeschloss	PART_OF
Sparsamkeit	Diskretion	HYPER
funkeln	Kraft	HYPER
Sprache	Herausforderung	RANDOM
Implosion	Verschlusslaut	PART_OF
Gehäuse	Gebäude	PART_OF
gecharterten	unchartered	ANT
bronziert	sonnengebräunt	SYN
herbstlich	sommerlich	ANT
achtziger Jahre	Alter	PART_OF
Mikrosekunde	Millisekunden	PART_OF
ligne	ft	PART_OF
Fall	Säugetier	RANDOM
Maklergeschäft	Sorge	HYPER
brennen	Wind	RANDOM
Frieden	halt	RANDOM
pyrrhic	messen	HYPER
Strand	glücklich	RANDOM
Ende	Konzert	PART_OF
wenig	Natur	RANDOM
Brokkoli	Brokkoli	PART_OF
Gürtel	Dach	RANDOM
beliebt machen	befriedigen	HYPER
Gegenteil	Beziehung	HYPER
Arithmetik	Waffe	RANDOM
absetzbar	nicht abzugsfähig	ANT
Kreuzung	hybridisierende	SYN
unterernährt	ernährte	ANT
Pubertät	Jugend	PART_OF
Bestand	Einstellung	ANT
bezahlt	unbezahlt	ANT
beschwatzen	Palaver	SYN
Allel	Faktor	HYPER
Keller	Weniger	RANDOM
Stille	waschen	HYPER
Harnröhre	Phallus	PART_OF
Kern	Vergnügen	RANDOM
Ruhm	Schande	ANT
irdisch	paradiesisch	ANT
Verantwortung	Ballaststoff	PART_OF
Lager	Plattform	PART_OF
Mittelhandknochen	Fausthandschuh	PART_OF
amphipod	Krebs	HYPER
Spalt	Lage	HYPER
Mischmasch	melange	SYN
extern	intern	ANT
Neffe	Nichte	ANT
viele	scads	SYN
Eishockey	Krankheit	RANDOM
am wenigsten	die meisten	ANT
Estragon	Estragon	PART_OF
Damm	Kilometer	PART_OF
Treue	Treue	SYN
verblassen	Aufschneiden	SYN
Film	Pflege	RANDOM
langweilig	ermüdend	SYN
Suspension	Triebwagen	PART_OF
Borte	Textil-	PART_OF
hoch	Stich	RANDOM
schlagen	schludrig	SYN
Tiefe	Oberflächlichkeit	ANT
Badewanne	Höhle	RANDOM
Quitte	Quitte	PART_OF
mißbrauchten	benutzt	ANT
Wirbel	Schlauchboot	PART_OF
Domino	Maskenspiel	PART_OF
Schlippstek	riata	PART_OF
raja	patrizisch	HYPER
Anfälligkeit	Bedingung	HYPER
Egress	Eintritt	ANT
Bob	Pendel	PART_OF
Unberechenbarkeit	Unsicherheit	HYPER
Impala	Antilope	HYPER
besser	schlechter	ANT
Frager	Schwätzer	HYPER
nachverfolgen	Produktion	HYPER
Zoll	ft	PART_OF
Bewegung	Verbrecher	RANDOM
künstlich	natürlich	ANT
töricht	weise	ANT
Mutagenese	Mutation	PART_OF
Penetration	Eingeben	HYPER
Strahl	Flosse	PART_OF
verdünnt	unverdünnt	ANT
grenzenlos	grenzenlos	SYN
Förder	Mühle	PART_OF
linkshändig	Rechtshändig	ANT
Pfund	cental	PART_OF
Polarlicht	Sonnenaufgang	SYN
Blut	gleich	RANDOM
Ablauf	Belüftung	PART_OF
Ratte	Frisur	PART_OF
Badewanne	Oberfläche	RANDOM
Gleichmäßigkeit	Unsicherheit	ANT
Lautstärke	Weichheit	ANT
Fondant	manipulieren	SYN
Heimatort	Stadt	HYPER
Niveau	falsch	RANDOM
Deckel	pflücken	RANDOM
Nadelkissen	Polsterung	HYPER
Sprache	Frau	RANDOM
20	zwanzig	SYN
Dystopie	Utopie	ANT
Lamelle	Knochen	PART_OF
Tintenfisch	Tintenfisch	PART_OF
Schrei	äußern	HYPER
östlich	Western	ANT
proportional	proportional	ANT
Haus	Handlung	RANDOM
bewusst	nicht bewusst	ANT
unähnlich	ähnlich	ANT
Spermatogenese	wachsend	HYPER
Reiter	Fahrer	HYPER
Geäder	Laub	PART_OF
Bett	entwickeln	RANDOM
Runway	Spur	SYN
Gemeinde	Bischofsamt	PART_OF
Hightech	Low-Tech	ANT
vererbt	übertragen	SYN
wiederkehrend	Wiederauferstandener	SYN
Dolmetscher	Übersetzer	SYN
Analphabetentum	Alphabetisierung	ANT
kosmopolitisch	provinziell	ANT
Kugelfisch	Kugelfisch	PART_OF
Geschichte	dünn	RANDOM
Segmentierung	Schwangerschaft	PART_OF
Ungleichgewichts	Gleichgewicht	ANT
Entscheidung	Entschlossenheit	SYN
lehnen	Spitze	SYN
Eignung	Untauglichkeit	ANT
ziellos	schwimmend	SYN
bedeuten	Süd	RANDOM
Förder	Manufaktur	PART_OF
dg	gm	PART_OF
Sperrung	Vertreibung	HYPER
Schließe	Geldbörse	PART_OF
Kalbfleisch	Kalb	PART_OF
perianth	Angiospermen	PART_OF
Implantation	Ortung	HYPER
Gans	Zucken	HYPER
Langeweile	Geheimnis	RANDOM
Gefängnis	Gesundheit	RANDOM
Himbeere	razz	SYN
niedrig	kleiden	RANDOM
Basketball	Element	RANDOM
Eigenartigkeit	Einzigartigkeit	SYN
verzeihen	gewähren	HYPER
Knoten	Residenz	RANDOM
optimistisch	pessimistisch	ANT
organisieren	gewerkschaftlich organisieren	SYN
hadj	Hadsch	SYN
beeindrucken	drucken	SYN
Abstimmung	Wählen	SYN
Helligkeit	Helligkeit	SYN
billig	knallig	SYN
Reim	Raureif	SYN
Beere	Beere	PART_OF
Luft	Lauf	RANDOM
schief	wackelig	SYN
grammatisch	ungrammatisch	ANT
ungelüftet	ventilierten	ANT
Kühle	Schärfe	ANT
Kapitalismus	Sozialismus	ANT
Airbrush	sprühen	HYPER
rührselig	schmalzig	SYN
intensiv	klug	SYN
zweibeinig	quadrupedal	ANT
Intensivierung	Moderieren	ANT
Presbyterium	Kirche	PART_OF
übertreffen	gehen	HYPER
Kaution	System	HYPER
Behemoth	Koloss	SYN
Gebärmutterhals	Gebärmutter	PART_OF
humorlos	humorvoll	ANT
Heraufbeschwörung	Enteignung	PART_OF
pinger	Echolot	PART_OF
Bewegung	Vergnügen	RANDOM
nach unten	nach oben	ANT
inzwischen	Intervall	HYPER
Wandschrank	Experiment	RANDOM
kubisch	linear	ANT
widmen	bestimmen	HYPER
Schwede	Steckrübe	PART_OF
Vogel	stehlen	RANDOM
Boot	Organ	RANDOM
blattlos	belaubt	ANT
Halluzination	habe gedacht	HYPER
Projektion	Prognose	HYPER
Main	primär	SYN
schwarz	geschwärzt	SYN
zärtlich	tippy	SYN
Fall	jemand	HYPER
Schulhaus	Gebäude	HYPER
Sammelband	Sammelsurium	SYN
Vereinigung	Festigung	HYPER
fabelhaft	rasselnd	SYN
Blitz	trice	SYN
bestehen	Kurve	RANDOM
federnd	flink	SYN
Ehe	eng	RANDOM
Centavo	boliviano	PART_OF
gimel	Graphem	HYPER
Katastrophe	Katastrophe	SYN
Öse	Vorhang	PART_OF
verlassen	Organismus	RANDOM
dominieren	Finsternis	SYN
Rechnung	Pfirsich	RANDOM
Vergangenheit	Komplex	RANDOM
Paragleiten	fliegend	HYPER
Peristom	wirbellos	PART_OF
Scan	Suche	HYPER
Tintenfisch	Tintenfisch	PART_OF
Rosa	Rap	SYN
hinzufügen	Held	RANDOM
Herstellung	ruhig	RANDOM
Gang	erweitern	RANDOM
Schmuck	Schmuck	SYN
Pedal	einzigartig	RANDOM
Block	stören	HYPER
am Leben	tot	ANT
Jungfernhäutchen	Vagina	PART_OF
Hindernis	Interferenz	SYN
Amerika	abgestanden	RANDOM
Vorderseite	Schlachtfeld	PART_OF
unbedeutend	von Bedeutung	ANT
gesegnet	verflucht	ANT
Arbeit	Mutterschaft	PART_OF
Phase	Zyklus	PART_OF
Haufen	Unmenge	SYN
Attraktor	jemand	HYPER
erweitern	erweitern	SYN
Stossen	Stoßen	SYN
rounders	Ballspiel	HYPER
Ansatz	Interesse	RANDOM
relict	Sein	HYPER
Arbeit	Nadel	RANDOM
Quart	Gallone	PART_OF
mieten	Krug	RANDOM
chaw	wiedergekäutes Futter	SYN
Lüge	in den Ruhestand gehen	RANDOM
Schokolade	Bühne	RANDOM
Ausschuss	interagieren	HYPER
Knoten	Streifen	RANDOM
Erbstück	Besitz	HYPER
Basketball	Gerechtigkeit	RANDOM
Horn	Dichtung	RANDOM
Grabstein	Aquädukt	PART_OF
Wanderer	Wanderer	HYPER
Gumbo	Okra	PART_OF
Anchorage	Hafen	PART_OF
hüpfen	einzigartig	RANDOM
überfüllt	laufenen	ANT
Analyse	Synthese	ANT
schmerzlich	schmerzlos	ANT
Versammlung	Demontage	ANT
Formalität	Ungezwungenheit	ANT
Japan	Gras	RANDOM
Karambolage	Bewegung	HYPER
Planetarium	Planetarium	PART_OF
Landung	Einschiffung	ANT
Angelegenheit	umkehren	RANDOM
Reich	Domain	HYPER
Nation	erhebt euch	RANDOM
bannister	Balkon	PART_OF
gunstock	Pistole	PART_OF
Ehrerbietung	Ehrfurcht	HYPER
gackern	klappern	SYN
Ausleger	widerstehen	SYN
zweite	hr	PART_OF
Überlegenheit	Vorherrschaft	HYPER
Verantwortung	Ballaststoff	PART_OF
Minuscule	Graphem	HYPER
Schmerzen	Befriedigung	RANDOM
organisiert	unionized	SYN
Übertragung	Evolution	ANT
widerlich	übel	SYN
Vermaschung	Netzwerk	SYN
heben	äußern	HYPER
unreif	unreif	SYN
Analphabet	gebildet	ANT
Salzgehalt	Salzigkeit	SYN
Hochsommer-	Sommer-	PART_OF
blass	Kissen	RANDOM
Anzahlung	stellen	HYPER
interessant	uninteressant	ANT
hacken	Flüssigkeit	RANDOM
bevorstehend	abgehend	SYN
beißend	durchdringend	SYN
Chili	Chili	SYN
Bischofsamt	Gebiet	HYPER
Laufen	Stehen	ANT
Persönlichkeit	jemand	PART_OF
Exponent	Befürworter	SYN
ärgerlich	aufreizend	SYN
Soja	Soja	PART_OF
Joggen	Unterbrechung	RANDOM
Puff	Rauchen	PART_OF
Ballaststoff	jemand	PART_OF
Schürze	Feld	PART_OF
Schleuse	Schleuse	PART_OF
Mollusken	Schaltier	SYN
Freisetzung	übertragen	HYPER
Sprichwort	Sprichwort	HYPER
Salon	Domizil	PART_OF
Demut	Tastatur	RANDOM
neunziger Jahre	Jahre	PART_OF
genau	ungenau	ANT
Nachwuchs	schlagen	RANDOM
Nacken	Gebärmutterhals	PART_OF
Adapter	transcriber	SYN
Balance	Topf	RANDOM
Flugblatt	Pumpe	PART_OF
Mensch	Auftrag	RANDOM
innerlich	nach außen hin	ANT
gewöhnliche	gestalten	RANDOM
Puzzle	spekulieren	HYPER
feige	gutsy	ANT
Brust	Aussicht	RANDOM
Vogel	Stress	RANDOM
klappern	Konversation	HYPER
beschämt	schamlos	ANT
Unvollkommenheit	Perfektion	ANT
Schnauze	Fauna	PART_OF
falten	Übernehmen	HYPER
Präsidium	Kommission	HYPER
Fußhebel	Zyklus	PART_OF
miro	Nadelbaum	HYPER
gehen	harmonisieren	HYPER
Anmut	Verhalten	HYPER
Flattop	Frisur	HYPER
Generalist	Spezialist	ANT
Öffnung	Fernrohr	PART_OF
Speerspitze	Lanze	PART_OF
Wählbarkeit	Sperre	ANT
Blatt	behalten	RANDOM
Okra	Gumbo	PART_OF
Matrix	Ziffer	PART_OF
Klammer	pflegen	RANDOM
Infrastruktur	System	PART_OF
Modellierer	jemand	HYPER
innere	äußere	ANT
ausgebeutet	ungenutzt	ANT
Gurt	Gepäck	PART_OF
Pollard	Klammer	HYPER
Konvergenz	Abweichungen	ANT
Bogen	Wasserfahrzeug	PART_OF
Taschentuch	Textil-	HYPER
picken	Quartal	PART_OF
Schläfrigkeit	Wachsamkeit	ANT
Wanderarbeiter	Zug-	SYN
Schluck	Portion	PART_OF
Braten	sauteing	SYN
Kuppler	Übeltäter	HYPER
schnell	ablassen	HYPER
Hähnchen	bräunen	RANDOM
Wachtmeister	Verteidiger	HYPER
Abwind	Aufwind	ANT
hell	weich	RANDOM
Ginseng	Ginseng	PART_OF
Richter	Strafverfolgung	RANDOM
Insolvenz	Zahlungsfähigkeit	ANT
anerkannt	uneingestanden	ANT
Penis	böse	RANDOM
platzen	passen	SYN
Sauerstoff	Haus	RANDOM
Mississippi	langsam	RANDOM
Morgen	Tageslicht	PART_OF
gimpy	Halt	SYN
stationäre	ambulant	ANT
dezimieren	beseitigen	SYN
Fähigkeit	Unfähigkeit	ANT
unpassierbar	befahrbar	ANT
Neffe	Nichte	ANT
Köder	Rallye	SYN
Chile	Jalapeno	PART_OF
in Flammen	aufgeregt	SYN
Mississippi	Kommen Sie	RANDOM
reinigen	Bitte	RANDOM
Sauerkirsche	Sauerkirsche	PART_OF
Badewanne	Kette	RANDOM
Maus	Freundlichkeit	RANDOM
Chip	Unglück	RANDOM
sprengen	verdrängen	HYPER
Schmerzen	Literatur	RANDOM
Kick	kvetch	SYN
Schaufel	Gefieder	PART_OF
machbar	handhabbar	SYN
verwirrende	Orientieren	ANT
Zorn	Brief	RANDOM
Rindfleisch	Geheimnis	RANDOM
Sturz	verringern	HYPER
anständig	unanständig	ANT
Backe	caput	PART_OF
Festnahme	Prise	SYN
formbar	Zug-	SYN
Schadenersatz	Wiedergutmachung	SYN
erholsam	unruhig	ANT
Verteidigung	Delikt	ANT
äquatorial	Polar-	ANT
Klingeln	Rosa	SYN
en	em	PART_OF
kitschig	rührselig	SYN
Umlegung	Parzellierung	SYN
müßig	Herstellung	RANDOM
clavier	Klavier	PART_OF
aufsteigend	Bedingung	HYPER
Vielfalt	Vielfalt	SYN
Süßigkeiten	Kabel	RANDOM
kollusive	conniving	SYN
Skeptiker	intellektuelle	HYPER
Süßigkeiten	Tasse	RANDOM
Bedeutung	Botschaft	HYPER
Mittagessen	rot	RANDOM
Atmosphäre	füllen	RANDOM
Maus	Regenschirm	RANDOM
Konkurs	Vorgehen	HYPER
Kalb	Blatt	RANDOM
mutig	Autobahn	RANDOM
Komödie	Tragödie	ANT
Schokolade	Neutron	RANDOM
Nervenkitzel	anregen	HYPER
Geländer	Balkon	PART_OF
Nachbrenner	Turbofan	PART_OF
brennen	Monokel	RANDOM
Rotor	Zündung	PART_OF
Hinterteil	Torso	PART_OF
grunzen	grunz	SYN
Pastor	ehrwürdig	HYPER
Mesh	reißen	HYPER
sanitär	unhygienisch	ANT
Staubblatt	blühen	PART_OF
gelandet	landlos	ANT
Gürtel	äußern	HYPER
Süßigkeiten	Wort	RANDOM
Verwandtschafts	Verbindung	HYPER
stocken	stockend	SYN
deformiert	unförmig	SYN
angrenzen	Rand	SYN
Substrat	Komponente	HYPER
Miniaturansicht	Daumen	PART_OF
qualifizieren	erfüllen	HYPER
unbotmäßig	untergeordnet	ANT
Ausstellung	Gruppierung	HYPER
Ungnade	identifizieren	HYPER
Hügel	Fenster	RANDOM
Bogen	Kleid	RANDOM
Tier	Bedienung	RANDOM
Ärmel	Kleidungsstück	PART_OF
unaufrichtig	unbefangen	ANT
pecker	Welle	SYN
Helm	Motorboot	PART_OF
Gürtel	Hobby	RANDOM
lernen	Kissen	RANDOM
Gemeinsamkeit	Individualität	ANT
aufhellen	ändern	HYPER
besiegt	discomfited	SYN
Banknote note~~POS=HEADCOMP	Dollar	SYN
brennen	Schnee	RANDOM
Ball	Schüler	RANDOM
Fehler	cool	RANDOM
küssen	Vorspiel	HYPER
Augmentation	Verminderung	ANT
fügsam	stur	ANT
glop	Brei	SYN
antagonistisch	synergistische	ANT
Schleuse	Zurückhaltung	HYPER
Jogginghose	Trainingsanzug	PART_OF
Schicht	laminieren	PART_OF
Cannabis	Sieg	RANDOM
Kabine	Raumfahrzeug	PART_OF
Tastatur	denken	RANDOM
zuerst	Auto	PART_OF
Klarheit	Dunkelheit	ANT
Spott	spotten	HYPER
hochkarätiges	Belag	SYN
höflich	unhöflich	ANT
Küsser	Homo	PART_OF
Markt	Rahmen	RANDOM
Dysphorie	Euphorie	ANT
schwimmfähig	terrestrisch	ANT
Ablehnen	Verbesserung	ANT
Millennium	ism	HYPER
Klinge	Uhr	RANDOM
4	Ziffer	HYPER
Veröffentlichung	Produkt	HYPER
stromab	stromauf	ANT
prüfen	verzögern	SYN
dornenlos	spinous	ANT
änderbar	veränderlich	SYN
schräg	parallel	ANT
Niveau	Statue	RANDOM
Pflug	verwandeln	HYPER
zerstreuen	informieren	HYPER
verweigern	verleugnen	HYPER
sechziger Jahre	Jahre	PART_OF
armselig	nichtig	SYN
Weitblick	Alterssichtigkeit	SYN
Schublade	Buffet	PART_OF
Geburt	Sie	RANDOM
sphenoid	Schädel	PART_OF
Schließe	Tasche	PART_OF
Wheeler	Handwerker	HYPER
Schnipsel	snipping	SYN
Schutz	stellen	HYPER
niedriger	Wüste	RANDOM
Arbeit	Schwangerschaft	PART_OF
nach vorne	weiter	SYN
Schlafzimmer	müßig	RANDOM
Chip	Fleck	SYN
alt	gut	RANDOM
blanchieren	erbleichen	SYN
Jagd	umleiten	HYPER
caput	Fauna	PART_OF
Centavo	quetzal	PART_OF
Mut	Schüchternheit	ANT
Desorganisation	Störung	HYPER
Behälter	wertvoll	RANDOM
mampfen	Ernährung	HYPER
Elfenbein	Stoßzahn	SYN
Patella	Knie	PART_OF
kreuzigen	Kies	HYPER
entehren	Schande	SYN
Krawall	Tumult	SYN
Grundpfeiler	Bogen	PART_OF
verletzt	Null	RANDOM
Dumpfheit	Schärfe	ANT
eilen	Eile	SYN
Satsuma	Satsuma	PART_OF
äußerlich	im Inneren	ANT
FKK-	jemand	HYPER
expansiv	großartig	SYN
Organ	Wolke	RANDOM
Stift	Platz	RANDOM
bestehen	verwechseln	RANDOM
cc	mil	SYN
buss	Kuss	SYN
mögen	Haus	RANDOM
Wählbarkeit	Sperre	ANT
Unwahrscheinlichkeit	Wahrscheinlichkeit	ANT
Basketball	Münze	RANDOM
Prognose	Diagnose	HYPER
Muskatnuss	Muskatnuss	PART_OF
zerquetschen	unterdrücken	SYN
Glied	Bogen	PART_OF
Neu	Papier-	RANDOM
inkorporiert	integriert	SYN
folgende	führend	ANT
downs	Theater	PART_OF
Medizin	weich	RANDOM
Barmherzigkeit	barmherzig	HYPER
harmonisieren	passen	HYPER
Ergebnis	Ergebnis	SYN
Kelch	Quirl	HYPER
Deflations	inflationär	ANT
Gefahr	Gefahr	SYN
Lockerung	Anziehen	ANT
schüchtern	erschrecken	HYPER
Ehe	Geschäft	RANDOM
Benommen	Symptom	HYPER
unentschieden	ungelöst	SYN
Kastanie	Kastanie	PART_OF
Kissen	Suspension	PART_OF
Spur	Eisenbahn	PART_OF
Verschuldung	Haftung	SYN
Strand	Prüfung	RANDOM
lernen	RAM	RANDOM
Milch	stark	RANDOM
Bart	Ziege	PART_OF
Rachen	Gebärmutterhals	PART_OF
fakultatives	verpflichten	ANT
tragen	kennt	RANDOM
Kapsel	Dosis	HYPER
glückselig	heiligmäßig	SYN
Eisen	nett	RANDOM
Embargo	ablehnen	HYPER
Flotte	Fluggesellschaft	PART_OF
Angelegenheit	tanzen	RANDOM
finagle	deichseln	SYN
Kollektiv	distributive	ANT
zentral	peripher	ANT
Verschluss	Kamera	PART_OF
hoch	Telefon	RANDOM
Gurt	teddy	PART_OF
Scheuern	Reinigung	HYPER
diplomatisch	undiplomatisch	ANT
komprimierbar	inkompressiblen	ANT
Güte	Attribut	HYPER
Vielfraß	Fleischfresser	HYPER
Sanktion	Ermächtigung	HYPER
kapillar	Thermometer	PART_OF
mil	Deziliter	PART_OF
Belastung	nutzen	HYPER
achtern	Vordergrund	ANT
Morgen	Seite	RANDOM
Rippe	Wasserfahrzeug	PART_OF
extravertiert	introvertiert	ANT
steigen	Schüler	RANDOM
Wohlwollen	Böswilligkeit	ANT
Gesichts-	Homo	PART_OF
mähen	Scheune	PART_OF
Zentimeter	Meter	PART_OF
wainwright	Geselle	HYPER
betrügen	Ausrüstung	SYN
Demut	Bild	RANDOM
Seebrücke	Spanne	PART_OF
Kloster	Sekte	PART_OF
Rinne	Kanal	SYN
Baracke	rühren	HYPER
Griffbrett	Akkordeon	PART_OF
voll	unvollzogen	ANT
Ascomycete	Sein	HYPER
Grabstein	Grab	PART_OF
Erzieher	Pädagoge	SYN
Echolot	Sonar	SYN
Zopf	verzerren	HYPER
Säugetier	Raum	RANDOM
klar	transparent	SYN
endlos	endlos	SYN
ethisch	unethically	ANT
Eifer	Elan	SYN
Rap	Zapfhahn	SYN
schließen	Garten	RANDOM
stromab	stromauf	ANT
Nachfolge	Bestellung	HYPER
Dock	Hafen	PART_OF
Albtraum	Träumerei	HYPER
puffer	puffer	PART_OF
ng	mg	PART_OF
Blau	Herstellung	RANDOM
Wahnsinn	geistige Gesundheit	ANT
konstruktiv	destruktiv	ANT
Rate	Serie	PART_OF
Anfang	beginnend	SYN
Kochen	Gang	RANDOM
Auflösung	profligacy	SYN
kühl	Jalapeno	PART_OF
betrügen	Schikane	SYN
verärgern	Lappen	HYPER
Finder	Umfang	PART_OF
Haft	Mutterschaft	PART_OF
Besserung	Verschlechterung	ANT
Hals	enorm	RANDOM
Abfuhr	ablehnen	HYPER
Schleudern	Schleudern	HYPER
wie	ähnlich	SYN
wild	wilde	SYN
Weltgericht	Ereignis	HYPER
Inhalation	Atmung	PART_OF
drinnen	draußen	ANT
Pilot	Seefahrer	HYPER
Ausschluss	Aufnahme	ANT
astronomisch	astronomisch	SYN
dominieren	überschatten	SYN
schwatzen	schmooze	HYPER
Locator	Ingenieur	HYPER
Stiefel	frei	RANDOM
Ignoranz	Stoff	RANDOM
duftend	malodorous	ANT
werden	verschönern	HYPER
verlangsamen	verzögern	SYN
Weiß	verfärben	HYPER
Harpune	Kupplung	HYPER
Teile	umgeben	HYPER
östlich	westlich	ANT
Autor	unzufrieden	RANDOM
Schlingpflanze	jemand	HYPER
vibes	vibraphone	SYN
Husten	Symptom	HYPER
verletzen	Panzer	RANDOM
Sitz	Motorboot	PART_OF
Collage	Akkumulation	HYPER
einfügen	äußern	HYPER
Hoffnung	bekommen	RANDOM
Antlitz	Homo	PART_OF
Boot	Wachstum	RANDOM
Wellenlänge	Haltung	HYPER
Gang	Standard	RANDOM
Prolog	Theater	PART_OF
Not	Schicksal	HYPER
Arena	Feld	HYPER
Centavo	austral	PART_OF
Gemeinheit	Nettigkeit	ANT
behalten	Homosexuelle	RANDOM
Modernismus	Genre	HYPER
Schlüssel	Socke	RANDOM
faul	klingen	RANDOM
Nähe	Offenheit	ANT
inspirierend	uninteressant	ANT
mittellos	Bedürftige	SYN
launisch	wunderlich	SYN
Aneurysma	verärgert	HYPER
Byte	Einheit	HYPER
Zack	Zick	SYN
hickey	Pickel	SYN
zuführenden	abführenden	ANT
Wegrand	Transit	PART_OF
mal	Betrieb	HYPER
Monismus	Pluralismus	ANT
wieder aufbauen	rekonstruieren	SYN
puffer	Kugelfisch	PART_OF
Monotheismus	Polytheismus	ANT
aussetzen	vertreiben	HYPER
cental	cwt	SYN
entschuldbar	unentschuldbar	ANT
freiberuflich	Freiberufler	SYN
Einstellung	Beihilfe	SYN
feiern	wassail	SYN
Krebs	Rennen	RANDOM
unspezifische	Spezifisch	ANT
Prolog	Theater	PART_OF
Vorhalle	Bereich	HYPER
Makrele	Veilchen	PART_OF
Pflege	Geschäft	RANDOM
Zentimeter	Meter	PART_OF
zwischenstaatlich	innerstaatliches	ANT
bewundern	produzieren	RANDOM
Euter	Kindermädchen	PART_OF
Aktivität	Inaktivität	ANT
intonierte	Singsang	SYN
Knoten	Stengel	PART_OF
Gitter	Gitter	SYN
Ungnade	Neigung	HYPER
Konsole	beruhigen	SYN
Kanal	vermitteln	SYN
männlich	unmännlich	ANT
bestätigen	autorisieren	HYPER
Puffer	Auto	PART_OF
Dominant	rezessiv	ANT
trafficker	vender	SYN
ungebührlich	unvernünftig	SYN
Hinweis	Ausflug	RANDOM
Laub-	immergrün	ANT
saree	Sari	SYN
zustimmend	disapprovingly	ANT
Absolution	Buße	PART_OF
verborgen	unverhüllt	ANT
weiter	des Weiteren	SYN
Segeltuch	Zelt	HYPER
Bienenwabe	Bienenstock	PART_OF
Abstammung	Abstammung	SYN
stymie	Position	HYPER
Badewanne	alle	RANDOM
Aufzug	ruhig	RANDOM
mischen	Aufregung	RANDOM
Kredite	Film	PART_OF
Unglücklicherweise	unglücklicherweise	SYN
huffing	Ausatmung	HYPER
äußerlich	innere	ANT
aerob	anaerobe	ANT
Säure	Alkalinität	ANT
abstrakt	Beton	ANT
schlachten	butchering	PART_OF
nach oben	Gebäude	PART_OF
Dialektik	Kunst	HYPER
Dram	Pfund	PART_OF
Anfang	Ende	ANT
Hals	Mineral	RANDOM
mich	Soldat	RANDOM
Fahrrad	weich	RANDOM
sockeye	Lachs	HYPER
Chili	Cayenne	PART_OF
in die falsche Richtung schicken	entweihen	SYN
Wohnung	alt	RANDOM
Förderung	Erziehung	SYN
Zuhause	gelingen	RANDOM
Mittelfeld	Schüssel	PART_OF
Passant	Reisende	HYPER
Hyperthermie	Unterkühlung	ANT
Datumsgrenze	Absendung	PART_OF
Stiefel	sehen	RANDOM
Kasserolle	Proviant	HYPER
erkranken	Schaden	HYPER
rasiert	unrasiert	ANT
Lunge	Droge	RANDOM
glänzen	Glitzern	SYN
Matrix	Daktylus	PART_OF
Rutsche	Rinne	HYPER
unpraktisch	windig	SYN
Party	Abdeckung	RANDOM
Himmel	Paradies	SYN
hinzufügen	gewöhnliche	RANDOM
Vorbeigehen	Änderung	HYPER
supplanting	Auswechslung	HYPER
Buffet	Wohnung	PART_OF
con	Profi	ANT
ziemlich	etwas	SYN
amüsiert	umgeleitet	SYN
Dussel	Sünde	SYN
wenig	Wüste	RANDOM
Horizont	Profil	PART_OF
Bluff	Fälschung	HYPER
prellen	vereiteln	SYN
Pyramide	Pose	HYPER
Verfassungs-	konstitutiv	SYN
Widerhaken	Lanze	PART_OF
Torheit	Weisheit	ANT
Zwischenruf	Interpolation	SYN
Guerilla	irregulär	SYN
Hyperthyreose	Hypothyreose	ANT
indoktrinieren	anweisen	HYPER
Klasse	Konstruktion	RANDOM
Mord	gelingen	RANDOM
Soße	Würze	HYPER
stecken	unstuck	ANT
Shanty	Vokal	HYPER
Regenwald	Botanik	HYPER
hieven	Palme	HYPER
Frieden	Not	RANDOM
Achtung	Sicherheit	ANT
Anruf	Besteck	RANDOM
gesammelt	gesammelt	SYN
extra	Besondere	SYN
Brust	Wagen	RANDOM
Schlippstek	Gin	PART_OF
tragen	reduzieren	RANDOM
Ausflug	Ausflug	SYN
hervorragend	wondrously	SYN
norther	nach Norden	SYN
Athlet	Lauf	RANDOM
Klasse	Flucht	RANDOM
springer	Arkade	PART_OF
federnd	temperamentvoll	SYN
Formalität	Trivialität	SYN
absolut	relativ	ANT
Gleichmäßigkeit	Unsicherheit	ANT
rechtmäßig	gesetzwidrig	ANT
Australien	gehen	RANDOM
Gefährte	twosome	PART_OF
Selbstverteidigung	Schutz	HYPER
Absender	Geschäftsperson	HYPER
Boden	ohne Boden	ANT
Steinbruch	unglücklich	HYPER
Über	in der Nähe von	SYN
Zuneigung	Freude	RANDOM
kratzen	Schlitz	SYN
Geißelung	Tracht Prügel	SYN
Boss	verbessern	RANDOM
Grobheit	Rauheit	HYPER
Sektion	Zitrusgewächs	PART_OF
Sicherheit	Unsicherheit	ANT
häufig	selten	ANT
Rebound	Reifen	PART_OF
prompt	sofort	SYN
kosmopolitisch	endemisch	ANT
Augur	Prognose	SYN
Erwachsene	Gepäck	RANDOM
Mausefalle	Manöver	HYPER
mcg	Milligramm	PART_OF
latschen	Rückgang	SYN
Stockwerk	Gebäude	PART_OF
Unreife	Reife	ANT
Fixer	Methadon	SYN
Bau	tauchen	HYPER
Scheisse	Ausscheidung	HYPER
Stoßstange	Auto	PART_OF
Rindfleisch	Ochsen	PART_OF
Unmoral	Moral	ANT
Schwere	Leichtfertigkeit	ANT
Runway	Feld	PART_OF
Apfel	Individuell	RANDOM
Kniescheibe	Knie	PART_OF
aufsteigen	Schatten	RANDOM
navigieren	manoeuver	HYPER
Hemmung	Uhr	PART_OF
bewegen	Verschiebung	SYN
Mundstück	Respirator	PART_OF
Heiligtum	Kirche	PART_OF
schleimig	hässlich	SYN
Maulwurfshügel	Hügel	HYPER
Ausschnitt	Jumper	PART_OF
kontinuierlich	diskontinuierliche	ANT
Richtigkeit	Unrichtigkeit	ANT
Verstärker	Tuner	PART_OF
hinzufügen	Hobby	RANDOM
blond	brünett	ANT
Schuss	Schuss	SYN
Karosserie	Auftrag	RANDOM
Geländer	Behinderung	HYPER
komponieren	beruhigen	HYPER
Quecksilber	Honig	RANDOM
Schwertfisch	Schwertfisch	PART_OF
Fitness	Untauglichkeit	ANT
akut	stumpf	ANT
grausam	fiel	SYN
Polster	Plattform	HYPER
dunker	Zubringer	HYPER
Rutsch	slithering	SYN
endogamy	exogamy	ANT
Druck	Antrieb	HYPER
informiert	nicht informiert	ANT
Start	tragen	RANDOM
sexy	unsexy	ANT
Gangway	Passage	HYPER
Vorherrschaft	Meisterschaft	SYN
Trommelfells	Trommel	PART_OF
verdammt	verflixt	SYN
Zivilisation	Liebling	RANDOM
Chassis	Homo	PART_OF
Trockendock	Werft	PART_OF
Ausatmung	Atmung	PART_OF
Taste	Union	RANDOM
mates	Clan	HYPER
crabapple	crabapple	PART_OF
auberge	Gasthaus	SYN
bringen	Lieferung	SYN
herauskommen	Route	PART_OF
entlarven	entlarven	SYN
unwürdig	würdig	ANT
Hähnchen	Ignoranz	RANDOM
Bauch	Torso	PART_OF
maximal	Minimum	ANT
Knie	Vierfüßler	PART_OF
Unregelmäßigkeit	Regelmäßigkeit	ANT
Plage	Mühe	HYPER
Beste	am schlimmsten	ANT
Klapperschlange	Klapperschlange	SYN
Demonstrant	Reisende	HYPER
Mann	Nacht-	RANDOM
Ausrüster	Auslauf	HYPER
Erweiterung	Flexion	ANT
rülpsen	platzen	HYPER
hohl	blass	RANDOM
besoffen	roiled	SYN
Wandteppich	Ornamentik	HYPER
neugierig	Romme	SYN
Sahne	dreschen	SYN
Darm	Venter	PART_OF
zentrifugal	zentripetal	ANT
Dowsing	foretelling	HYPER
Fußabdruck	Tinktur	HYPER
Blut	etwas	RANDOM
Minister	helfen	HYPER
Spann	Montage	PART_OF
Pfeffer	Pfeffer	PART_OF
kommentieren	Rede	HYPER
Kopilot	Flieger	HYPER
Anoxie	Hypoxie	HYPER
Serie	Beziehung	HYPER
Brokkoli	Gemüse	HYPER
Bass	Instrumentalist	HYPER
Schnauze	Kreatur	PART_OF
behalten	Satz	RANDOM
Land	Befriedigung	RANDOM
Ponton	Amphibie	PART_OF
Nachsatz	Schreiben	PART_OF
Angriff	Attacke	PART_OF
zähmen	wild	ANT
zeigen	Signal	SYN
Unwilligkeit	Bereitschaft	ANT
Chip	Pfote	RANDOM
Silbentrennung	Gruppierung	HYPER
multilateral	einseitig	ANT
lyrisch	großzügig	RANDOM
rauchfrei	rauchig	ANT
Heuhaufen	Heuhaufen	HYPER
Handlung	Bürgersteig	RANDOM
Welle	Feder	PART_OF
Initiative	Mädchen	SYN
illoyal	treu	ANT
Verschluss	Fass	PART_OF
Bonito	bonito	HYPER
midbrain	caput	PART_OF
Initiations	Mädchen	SYN
Minute	Krawatte	RANDOM
Schüssel	werfen	RANDOM
verfolgt	schienenlos	ANT
Abenteuer	gefährden	SYN
Nadir	Zenit	ANT
ermüden	Zuordnung	HYPER
Loch	Hitze	RANDOM
worfeln	entscheiden	HYPER
Stufe	Treppe	PART_OF
Outtake	Exposition	HYPER
Brücke	Hahn	RANDOM
Hertz	Kilohertz	PART_OF
Sauerstoff	singen	RANDOM
Mississippi	Design	RANDOM
Krippe	Krippe	PART_OF
Demontage	Abbau	SYN
eilig	geruhsam	ANT
Organ	Sicht	RANDOM
Matrose	roustabout	SYN
Vorhalle	Struktur	HYPER
Quecksilber	Ehepartner	RANDOM
schleppen	Lugger	PART_OF
Export	einführen	ANT
Rhombus	Viereck	HYPER
bergauf	Aufstieg	HYPER
Lichtempfindlichkeit	Sinn	HYPER
mobilisieren	sammeln	HYPER
Schutz	aufwenden	HYPER
schließen	Panzer	RANDOM
cinchona	Borke	HYPER
Spalt	Uneinigkeit	HYPER
Maus	Minute	RANDOM
Postleitzahl	Kittel	PART_OF
Geschichte	Universität	RANDOM
Bit	einzigartig	RANDOM
Monitor	Skelett	RANDOM
Vorsingen	Hören	SYN
Dumpfheit	Schärfe	ANT
ehemalige	letztere	ANT
Aggregator	Kollektor	SYN
Polster	Eckzahn	PART_OF
fünfte	Position	HYPER
Mensch	fest	RANDOM
Diele	Auto	PART_OF
Anruf	Regel	RANDOM
As	Überflieger	SYN
Parade	Promenade	SYN
Decke	Not	RANDOM
gefunden	hat verloren	ANT
Kriminalität	Nichtzahlung	HYPER
honigsüß	sirupartig	SYN
Ureinwohner	urzeitlich	SYN
Tonnen	wads	SYN
Schädel	Kreatur	PART_OF
Quad	Schenkel	PART_OF
unempfänglich	sinnvoll	ANT
Verstauchung	Twist	SYN
Taube	Falke	ANT
Liquidator	jemand	HYPER
Leck	Aufzug	RANDOM
Erbse	Erbse	PART_OF
Orange	Schwanz	RANDOM
quoin	Gebäude	PART_OF
Blatt	bedeuten	RANDOM
roh	roh	SYN
stoßen	angrenzen	HYPER
Seelachs	Pollack	PART_OF
Bewältigungs	Gebäude	PART_OF
Start	Krawatte	RANDOM
modern	erfüllen	RANDOM
Kick	Rückstoß	SYN
Kette	draußen	RANDOM
Arbeitsplatte	Zähler	PART_OF
Kaufen	halt	RANDOM
aktiv	Geschichte	RANDOM
Hoffnung	erziehen	RANDOM
Darm	Bauch	PART_OF
Brücke	sterblich	RANDOM
Eindringling	jemand	HYPER
Lockerheit	Dichtheit	ANT
Küsten	Inland	ANT
Knopf	stehlen	PART_OF
Beachtung	Unaufmerksamkeit	ANT
Disziplin	Disziplinlosigkeit	ANT
Effet	gieren	SYN
Feilschen	Gerangel	SYN
Sonar	Unter	PART_OF
Kreuzung	Route	PART_OF
Index	Stumpf	RANDOM
bestehen	Zigarette	RANDOM
Intelligenz	Dummheit	ANT
Keil	wedgie	PART_OF
hinzufügen	Blume	RANDOM
Nacht-	Familie	RANDOM
Schlüssel	Mode	RANDOM
beidhändig	Rechtshändig	ANT
Fülle	Knappheit	ANT
Kaper	Scherz	SYN
Einfrieren	Aktivität	HYPER
Riff	Mischen	SYN
runderneuern	ändern	HYPER
geregelt	unerledigt	ANT
Soloauftritt	Haken	HYPER
gerade	ungerecht	ANT
dado	Sockel	PART_OF
zurück	Wort	RANDOM
pavan	pavane	SYN
unterstützt	ohne Unterstützung	ANT
gleichzeitig	gleichzeitig	SYN
Wirbel	Befestigung	HYPER
verdientermaßen	unverdientermaßen	ANT
Härte	Steifheit	SYN
Aktivierung	Inaktivierung	ANT
Stärkung	Schwächung	ANT
Stuhl	Schriftsteller	RANDOM
Öffnung	Umfang	PART_OF
niedriger	verbinden	RANDOM
Tinte	niedrig	RANDOM
Ritzel	Fledermaus	PART_OF
bazar	Auslauf	HYPER
groß	Seite	RANDOM
Bürger	noncitizen	ANT
Geruch	Geruch	SYN
Dame	Wasserfall	RANDOM
Maschine	Gerechtigkeit	RANDOM
lax	Tempus	ANT
Kondensator	Zündung	PART_OF
Schaft	Kaffeetasse	PART_OF
erzählen	informieren	HYPER
Drift	Freilauf	SYN
sparen	zu Verfügung stellen	HYPER
Band	Fass	PART_OF
frat	Gilde	HYPER
Gottheit	unsterblich	SYN
Greens	Vegetarisch	HYPER
Keller	Linderung	RANDOM
verunreinigt	unverseuchten	ANT
Ebenheit	Unebenheit	ANT
Absehen	Fernglas	PART_OF
horizontal	geneigt	ANT
Elternteil	Penis	RANDOM
hingestreckt	ändern	HYPER
plappern	klappern	HYPER
Postleitzahl	keuchen	PART_OF
aufdecken	Aktivität	HYPER
Schwelle	Schwelle	PART_OF
Abweichung	Abweichungen	SYN
betont	unbelastet	ANT
Garage	Gebäude	HYPER
jährlich	ein Jahr	SYN
Mesh	ft	PART_OF
dürr	struppig	SYN
Schärfe	Weichheit	ANT
Medizin	Konflikt	RANDOM
Zentralisierung	Zusammenstellung	HYPER
Mass angefertigt	fertig	ANT
entgleisen lassen	untergraben	HYPER
Schulterblatt	Torso	PART_OF
Hase	Hase	PART_OF
verschroben	zärtlich	SYN
Wanderung	gehen	HYPER
Arsch	Torso	PART_OF
Fausthandschuh	Homo	PART_OF
Veränderung	Mann	RANDOM
wiederkehren	Urlaubsort	SYN
kratzen	Kratzen	SYN
Nabel	Torso	PART_OF
Hinweis	aufladen	RANDOM
nonsurgical	chirurgisch	ANT
41.	einundvierzigster	SYN
wohltätig	lieblos	ANT
placekicker	Kicker	HYPER
Niveau	Obst	RANDOM
zurückzahlen	Retorte	SYN
Augur	Seher	HYPER
Studentenverbindung	vergolden	HYPER
Konvergenz	Abweichungen	ANT
Bibliothek	Performance	RANDOM
Kommode	Wohnung	PART_OF
Zivilisation	Glauben	RANDOM
beheben	verfeinern	SYN
Centavo	dobra	PART_OF
Kalb	Werkzeug	RANDOM
übel riechend	stinkend	SYN
Zitrone	Zitrone	PART_OF
positiv	Negativ	ANT
Menschheit	Verstand	RANDOM
Resektion	Betrieb	HYPER
Trank	trinkbar	HYPER
raffiniert	nicht raffiniert	ANT
Batterie	Attacke	HYPER
Sendung	Ware	HYPER
erklärbar	unerklärlich	ANT
Serail	serail	SYN
Golf spielen	spielend	HYPER
Zähler	Wohnung	PART_OF
Einrichtung	Bequemlichkeit	SYN
Kreis	runden	SYN
Sadist	abweichen	HYPER
Zusammenhanglosigkeit	Substanz	HYPER
Mississippi	Programm	RANDOM
Austausch	transponieren	SYN
Detektor	Tuner	PART_OF
Besamung	Kopulation	PART_OF
perfekt	entzünden	RANDOM
Joggen	verbrauchen	RANDOM
die Schau stehlen	Theater	PART_OF
Minister	sich weigern	RANDOM
beldame	Hexe	SYN
in Verbindung gebracht	nicht miteinander verbunden	ANT
zuerst	letzte	ANT
Karte	Ehrlichkeit	RANDOM
verlangsamen	Änderung	HYPER
Tafel	einstellen	RANDOM
Kreuz	fortsetzen	HYPER
Angebot	Herd	SYN
Ehrlichkeit	Aufregung	RANDOM
bezaubernd	liebenswert	SYN
Finder	aufklärer	SYN
Moralismus	Ausdrucksweise	HYPER
Schularbeit	Arbeit	HYPER
Schleier	Plazenta	PART_OF
Differential	Berechnung	HYPER
organisiert	unorganisiert	ANT
verwickeln	Besorgnis	HYPER
Steckrübe	Schwede	PART_OF
Joint	Film	RANDOM
Assimilation	Lernen	HYPER
unilateralen	befürworten	HYPER
einladend	wenig einladend	ANT
Milliliter	ml	SYN
Unabhängigkeit	traurig	RANDOM
Japan	Vision	RANDOM
künstlich	natürlich	ANT
Linie	cool	RANDOM
Bedeutungslosigkeit	Bedeutung	ANT
ausschließen	Mangel	HYPER
mieten	draußen	RANDOM
Proszenium	Theater	PART_OF
Visier	Helm	PART_OF
Auto	verunreinigen	RANDOM
Kessel	Tympanum	SYN
Bild	Phrase	RANDOM
Quirl	Frisur	PART_OF
Schwalbenschwanz	Frack	PART_OF
Kinderspiel	Geschirr	PART_OF
Langeweile	sparen	RANDOM
Tafel	Erholung	RANDOM
Sperrfeuer	Batterie	SYN
prep	Pädagogie	PART_OF
zuversichtlich	zaghaft	ANT
Mitte	Belohnung	RANDOM
Decke	reifen	RANDOM
Eierstock	blühen	PART_OF
Verwüstung	Zerstörung	HYPER
Bundes-	einheitlich	ANT
Land	Belohnung	RANDOM
prüfen	Untätigkeit	HYPER
Dissonanz	Harmonie	ANT
brennen	Politiker	RANDOM
produktiv	unproduktiv	ANT
unterzeichnet	ohne Vorzeichen	ANT
mil	Zoll	PART_OF
Besamung	Beziehung	PART_OF
Mann	Selten	RANDOM
Wissen	Krankheit	RANDOM
Kalb	Schaft	PART_OF
numerisch	verbal	ANT
berührt	unberührt	ANT
toll	ordentlich	SYN
Index	Überschrift	ANT
Hyperthermie	Unterkühlung	ANT
Zweifler	Skeptiker	SYN
Quartal	Zentner	PART_OF
Format	Veröffentlichung	PART_OF
Vogel	beißen	RANDOM
fruchtbar	unfruchtbar	ANT
zweideutig	eindeutig	ANT
furchtbar	Furcht erregend	SYN
Zwischendeck	Navigation	PART_OF
brüsk	ohne Umschweife	SYN
prospektiv	retrospektiv	ANT
Hamster	Plazenta	HYPER
knochig	verkniffen	SYN
Kohärenz	Zusammenhanglosigkeit	ANT
stimmlos	stimmhaft	ANT
die Genehmigung	Lob	SYN
Läufer	Schlitten	PART_OF
Anatomie	Homo	PART_OF
Angriff	Beginn	PART_OF
machen	einreichen	SYN
Pilger	Anbeter	HYPER
mit Recht	ungerecht	ANT
Peristom	Kapsel	PART_OF
gefüllt	ungefüllt	ANT
Bogen	Bogen	SYN
Atonalität	Tonalität	ANT
Bollwerk	munition	PART_OF
evasiveness	Unehrlichkeit	HYPER
untersuchen	untersuchen	HYPER
Delegieren	Management	HYPER
Fang	voll	RANDOM
nackt	roh	SYN
spotten	behandeln	HYPER
Nichtverbreitung	Proliferation	ANT
Herstellung	sauer	RANDOM
Samisdat	Mittel	HYPER
gunstock	Artillerie	PART_OF
steigen	erfolgreich	RANDOM
Rinne	Sattel	PART_OF
Geländer	bannister	SYN
kastanienbraun	pyrotechnische	HYPER
Chor	Heiligtum	PART_OF
Schauspielkunst	Kunst	HYPER
Widerhaken	Gefieder	PART_OF
Echo	erklingen	SYN
Lüge	Kind	RANDOM
ausweichen	Hecke	SYN
ermahnen	ermutigen	HYPER
Kraft	vim	SYN
beinig	ohne Beine	ANT
Linse	Error	RANDOM
Sampler	Vielfalt	HYPER
Pfropfung	Kombination	HYPER
Orchester	Theater	PART_OF
Nase	Problem	RANDOM
Konglomerat	Montage	HYPER
Bild	Maschine	RANDOM
Konto	Mensch	RANDOM
Querruder	Strömungsprofil	HYPER
bolide	Feuerkugel	SYN
Delikatesse	Ernährung	HYPER
allopatric	sympatric	ANT
Kreuzung	Kreuzung	SYN
Gemeinheit	Nettigkeit	ANT
Öffnung	oculus	PART_OF
Bild	unzufrieden	RANDOM
Vorland	Strand	PART_OF
Kleiderschrank	tragbar	PART_OF
Folge	Serie	PART_OF
Blut	Streik	RANDOM
Main	Infrastruktur	PART_OF
Säugetier	verletzen	RANDOM
monochromatische	mehrfarbig	ANT
Gletscherspalte	Spalt	HYPER
Kaper	gebunden	HYPER
nichts	Frieden	RANDOM
hoffnungsvoll	hoffnungslos	ANT
Allgemeines	Spezifisch	ANT
Schild	Mollusken	PART_OF
Abschirmung	Artefakt	HYPER
heiß	Rennen	RANDOM
Dock	Hafen	PART_OF
runden	Konzeption	HYPER
dramatisieren	sticken	SYN
Verschiebung	ändern	HYPER
Zelle	Geschenk	RANDOM
Unrechtmäßigkeit	Legitimität	ANT
Rate	seriell	PART_OF
Boss	Verbreitung	RANDOM
Seersucker	Textil-	HYPER
Minute	glücklich	RANDOM
streichelnd	Erregung	HYPER
Pepsin	Katalysator	HYPER
Hähnchen	Interesse	RANDOM
Adjektiv	materiell	ANT
Polster	Fausthandschuh	PART_OF
Nachwuchs	Flugzeug	RANDOM
Stirn	Schädel	PART_OF
erinnern	interagieren	HYPER
Überschneidung	Route	PART_OF
Schrägstrich	Wunde	HYPER
Immergrün	Strandschnecke	SYN
seriell	Übertragung	HYPER
Strebe	stolzieren	SYN
systematisch	unsystematisch	ANT
Armband	Ärmel	PART_OF
Wasser-	terrestrisch	ANT
Krankheit	Handy	RANDOM
brennen	heiraten	RANDOM
Prellung	Wunde	HYPER
Effektor	Rezeptor	ANT
auszahlen	Transfer	HYPER
gekürzte	ungekürzt	ANT
Selbstschutz	Schutz	HYPER
erregen	ändern	HYPER
Großonkel	Großonkel	SYN
Rebellion	Widerspenstigkeit	HYPER
dramatisch	lyrisch	ANT
überparteiliche	Partisan	ANT
Stumpf	Gatter	PART_OF
Haupt	geringer	ANT
unanständig	ungehörig	SYN
immer	immerdar	SYN
glaubwürdig	unglaublich	ANT
Geheimschrift	Kryptologie	SYN
Ratan	Rattan	SYN
entlarven	aufdecken	SYN
Weg	weiter	SYN
gesättigt	ungesättigt	ANT
Helligkeit	Dumpfheit	ANT
Klirren	Knast	SYN
Vorlesungen	Kurs	PART_OF
wahrhaftig	unwahr	ANT
Bar	Gesundheit	RANDOM
hüpfen	Aktie	RANDOM
wütend machen	erregen	HYPER
Streuung	Aussterben	PART_OF
Einstellung	Neueinstellung	SYN
klassifizieren	verweisen	SYN
fegen	Orbit	HYPER
mögen	heidnisch	RANDOM
Schiene	Eisenbahn	HYPER
Vogel	Gang	RANDOM
Homosexuelle	Vertrauen	RANDOM
Kehle	Hals	PART_OF
Eisenwarenhändler	Auslauf	HYPER
Planke	Pose	HYPER
Guckloch	Öffnung	HYPER
Gefängnis	Glauben	RANDOM
unerlaubte Handlung	Aktivität	HYPER
Kreuzbein	Hüfte	PART_OF
Abenteuer	Zahn	RANDOM
Gebäck	kann	SYN
Vorhersagbarkeit	Unberechenbarkeit	ANT
Schwere	Aufrichtigkeit	SYN
Dort	dorthin	SYN
Snapper	Snapper	PART_OF
Leitwerk	Rumpf	PART_OF
Verengung	Erweiterung	ANT
hatful	reichlich	SYN
Papier-	Bleistift	RANDOM
spreizen	Bewegung	HYPER
machen	Rock	RANDOM
Joint	mögen	RANDOM
Sprache	Fix	RANDOM
Angebot	liefern	HYPER
kauen	mampfen	SYN
Kalif	khalifah	SYN
tragen	mächtig	RANDOM
erhöhen	schärfen	SYN
Zuhause	Prüfung	RANDOM
Fontanelle	Schädel	PART_OF
Sänger	Texter und Komponist	SYN
reichlich	mager	ANT
Sperrfeuer	Attacke	HYPER
besorgniserregend	Bewegung	HYPER
überzeugt	nicht überzeugt	ANT
grell	gammelig	SYN
unnachgiebig	unerbittlich	SYN
Hügel	Ignoranz	RANDOM
untypisch	typisch	ANT
Pflege	Autobahn	RANDOM
Menschheit	mächtig	RANDOM
Gefährte	Verspaar	PART_OF
Teenageralter	Erwachsensein	PART_OF
hohe Auflösung	niedrige Auflösung	ANT
binden	Text	RANDOM
Mitte der siebziger Jahre	Alter	PART_OF
respektlos	ehrerbietig	ANT
Gurt	BH	PART_OF
Ozean	Handlung	RANDOM
mögen	Skelett	RANDOM
Kapitol	Gebäude	HYPER
Auswertung	Bewertung	HYPER
schreiend	Äußerung	HYPER
Destabilisierung	Stabilisierung	ANT
Homosexuelle	kommunizieren	RANDOM
verteilen	staffeln	SYN
Öse	Leichentuch	PART_OF
Scharnier	Gebäude	PART_OF
nonracial	rassisch	ANT
Mikrometer	Millimeter	PART_OF
aspirieren	aussprechen	HYPER
Refrain	Vokal	PART_OF
Mark	Nahrung	HYPER
Verzögerung	Änderung	HYPER
Vorhaut	Taste	PART_OF
Unbrauchbarkeit	Durchführbarkeit	ANT
angemessene	unzureichend	ANT
Stift	Ernte	RANDOM
Chiffre	Null	SYN
angeben	erhellen	HYPER
Nabel-	Fötus	PART_OF
meinen	erwarten	HYPER
herzhaft	befriedigend	SYN
Kondylus	Knochen	PART_OF
Egress	Problem	SYN
flintlock	flintlock	PART_OF
Pirschjäger	Fußzeile	HYPER
wirbellos	Wirbeltier	ANT
Ersatz	Füllung	HYPER
sicher	unsicher	ANT
sommerlich	Frühlings-	ANT
gefährlich	lebensbedrohliche	SYN
verkauft	unverkauft	ANT
Anhängsel	Auswuchs	SYN
Miene	Gegenwart	SYN
Rap	Zapfhahn	SYN
ziemlich	unfair	ANT
Legion	zahlreich	SYN
Spielerei	Twist	SYN
Führer	Auftrag	RANDOM
wenige	viele	ANT
Schote	Flugzeug	PART_OF
vollendet	herrisch	SYN
Dämmerung	Vorabend	PART_OF
Kern	Bedeutung	HYPER
Galeere	Verkehrsflugzeug	PART_OF
Krächzen	verfallen	SYN
Schwere	Leichtfertigkeit	ANT
Muse	wiederkäuen	SYN
Punk	schmierigen	SYN
Empfangshalle	Kommunikation	RANDOM
Tuner	kabellos	PART_OF
Arbeit	Post	RANDOM
Wagen	gesund	SYN
Piment	Piment	PART_OF
Stiefel	Lauf	RANDOM
Ball	Zeit	RANDOM
siebziger Jahre	Alter	PART_OF
Experimentator	Sein	HYPER
aufrecht	Torpfosten	PART_OF
Zufluss	Abfluss	ANT
r	Durchmesser	PART_OF
Darm	Venter	PART_OF
Zuneigung	Ausrüstung	RANDOM
Koloss	Schwergewicht	SYN
Spur	Straßenbahn	PART_OF
weiterverkaufen	Transfer	HYPER
verletzt	Entspannen Sie Sich	RANDOM
brutal	bösartig	SYN
Safran	Safran	PART_OF
Konservatismus	conservativism	SYN
Ebenheit	Unebenheit	ANT
Schaft	Schlägerkopf	PART_OF
repatriieren	National	HYPER
Nanosekunde	Millisekunden	PART_OF
adoptieren	akzeptieren	HYPER
Gesang	Unterteilung	HYPER
einführen	Reisende	HYPER
Aktion	saugen	RANDOM
Floater	Begründung	HYPER
recommit	erreichen	HYPER
aussehen	Baum	RANDOM
evokativ	duftend	SYN
Stichelei	höhnen	SYN
achtern	Vordergrund	ANT
fleischlos	fleischig	ANT
Rotor	Stator	ANT
Billigung	Sanktion	SYN
Gürtel	Medizin	RANDOM
Zentrifuge	Dreh	HYPER
sperren	reproduzieren	RANDOM
niedrig	Aussicht	RANDOM
kapitalistisch	sozialistischer	ANT
Aktionär	Aktionär	SYN
Kumpel	Scheich	SYN
fünfziger Jahre	Reife	PART_OF
widerspenstig	feuerfest	SYN
Blut	Gang	RANDOM
Ansatz	öffnen	RANDOM
Linse	Mode	RANDOM
Spanne	Transit	PART_OF
Nelke	Nelke	PART_OF
Spritzer	Verspritzen	SYN
Boss	Ideologie	RANDOM
Hurra	die Genehmigung	HYPER
Borretsch	Borretsch	PART_OF
Verzögerung	Ereignis	HYPER
überparteiliche	Partisan	ANT
Rechnung	Fleisch	RANDOM
körperlich	körperlos	ANT
Gräber	Bagger	SYN
schlüssig	ergebnislos	ANT
verschieden	schneidend	SYN
Kochen	Wende	RANDOM
immer noch	ändern	HYPER
delegieren	benennen	SYN
geschickt	ungeschickt	ANT
Tülle	Spurt	SYN
Barbarei	Unmenschlichkeit	HYPER
Artikel	Zeichen	SYN
These	Prämisse	HYPER
Kern	Substanz	SYN
Königtum	Kosten	HYPER
ungenügend	ausreichend	ANT
unaufhörlich	unaufhörlich	SYN
Erz	krone	PART_OF
Bürzel	Torso	PART_OF
Kamerad	Bleistift	RANDOM
möbliert	unmöbliert	ANT
Lehnsherrschaft	Knüppel	HYPER
kalben	liefern	HYPER
Schublade	Anrichte	PART_OF
Kauf	Einkauf	SYN
Joint	Proton	RANDOM
Unbeweglichkeit	Mobilität	ANT
checker	Ermittler	HYPER
meckern	Kick	HYPER
Verdecken	Aufschlussreich	ANT
Vorfahr	Nachkomme	ANT
As	wetteifern	HYPER
Gipfel	Tip Top	SYN
tatsächlich	Ja wirklich	SYN
Randstein	Randstein	SYN
abwehrend	abschätzig	SYN
Ächtung	Ablehnung	HYPER
Landung	Gebäude	PART_OF
Buggy	bekloppt	SYN
jubeln	beurteilen	HYPER
mikroskopisch	mikroskopischer	SYN
mögen	West-	RANDOM
Horn	Fernsehen	RANDOM
Kapitän	Soldat	RANDOM
Ausbuchtung	stoßen	SYN
Ford	Wasserlauf	PART_OF
Ausrüstung	herauskommen	SYN
stämmig	dick	SYN
Krüppel	Lame	SYN
Atomismus	Holismus	ANT
Adhäsion	Klebrigkeit	HYPER
Unsichtbarkeit	Sichtweite	ANT
Spitze	bestehen	RANDOM
Abraten	Überzeugung	ANT
Gefängnis	Schmelze	RANDOM
Rampenlicht	Schürze	PART_OF
schwappen	liefern	HYPER
Verengung	spitz zulaufend	SYN
Zahl	jemand	PART_OF
Zweisitzer	Auto	HYPER
Quacksalber	Betrüger	HYPER
Streikposten	erkunden	SYN
Getriebe	Motor	PART_OF
nichtsteroidale	steroidale	ANT
Atmosphäre	schwach	RANDOM
snafu	pfuschen	HYPER
Decken	platt	ANT
Geburtstag	alt	RANDOM
submarine	Matrose	HYPER
Gladiole	Thorax	PART_OF
Countdown	übereinstimmen	HYPER
Heuboden	Scheune	PART_OF
Richter	sperren	RANDOM
Zubehörteil	Ergänzung	SYN
Flüssigkeit	böse	RANDOM
Augenbraue	Homo	PART_OF
Extravertiertheit	Introvertiertheit	ANT
Zwickel	Kleidungsstück	PART_OF
Grabstein	Grab	PART_OF
Ziel	Schreiben	PART_OF
Brust	Rauch	RANDOM
abziehen	subtrahieren	SYN
Antipathie	Abneigung	SYN
Traufe	Gebäude	PART_OF
ein Stück	zwei Stück	ANT
Landung	Landung	HYPER
Schicksal	übernatürlich	PART_OF
Vergangenheit	Schmerzen	RANDOM
wahrscheinlich	Potenzial	SYN
Geißel	Samen	PART_OF
Klirren	Absturz	SYN
charakteristisch	uncharakteristisch	ANT
Berg	Person	RANDOM
Öse	Mantel	PART_OF
Latte	Gitterwerk	PART_OF
Säugling	liefern	HYPER
Turbofan	Turbofan	PART_OF
Paddel	verdrängen	HYPER
autorisiert	autorisiert	SYN
veröffentlicht	unveröffentlicht	ANT
Bauch	Torso	PART_OF
taub	Hören	ANT
sprengen	Pranger	SYN
Bett	Studie	RANDOM
passend	unpassend	ANT
Arbeit	hoch	RANDOM
mischen	Farbe	RANDOM
Gut	Nation	PART_OF
egalitären	elitär	ANT
Analphabetentum	Alphabetisierung	ANT
Überdenken	überdenken	SYN
Orange	Wörterbuch	RANDOM
konfrontiert	gesichtslos	ANT
Schädlingsbekämpfungsmittel	Sachen	HYPER
mil	dl	PART_OF
Adapter	Vermittlung	HYPER
eckig	gerundet	ANT
Niveau	Belohnung	RANDOM
Bug	Vorderseite	HYPER
Wohnung	einfach	RANDOM
Dope	Skunk	SYN
Bewaffnung	entwaffnend	ANT
degradierte	verschwenderisch	SYN
nichtkonfessionell	konfessionell	ANT
Haken	erbitten	SYN
erotica	porno	SYN
unsachgemäß	richtig	ANT
Anteil	zocken	HYPER
Scannen	Replikation	HYPER
Mitte	Venus	RANDOM
Weihe	Übeltäter	HYPER
renege	Karten	PART_OF
Mann	Seite	RANDOM
Ungnade	Haltung	HYPER
Sonnenschirm	Schutz	HYPER
spöttisch	Respektlosigkeit	HYPER
Fall	nicht nett	RANDOM
im Ausland	entfernt	SYN
Agentur	Darstellung	SYN
Explosion	Verschlusslaut	PART_OF
verbleit	bleifrei	ANT
Junkie	junky	SYN
Unreife	Reife	ANT
posieren	Sitzung	SYN
stehlen	Dieberei	SYN
downs	die Schau stehlen	ANT
rückläufig	steigend	ANT
Erwachsene	Schrei	RANDOM
Jacke	Süd	RANDOM
Verruf	Ruf	ANT
Stift	missfallen	RANDOM
Stoßzahn	Eber	PART_OF
hemmen	beschränken	HYPER
Kegel	optisch	PART_OF
Schlägerei	machen	SYN
Vorteil	Nachteil	ANT
fördern	beleben	HYPER
Klausel	Papiere	PART_OF
Taille	Torso	PART_OF
Extrusion	hervorragen	SYN
keister	Torso	PART_OF
Chip	schwach	RANDOM
Feder	Stachelschwein	PART_OF
vierziger Jahre	Erwachsensein	PART_OF
tödlich	schicksalhaft	SYN
Stiefel	Wurzel	RANDOM
Beschwörung	Gebet	SYN
zurück	Problem	RANDOM
Tastatur	Haus	RANDOM
Entkolonisierung	Entkolonisierung	SYN
Schönheit	alt	RANDOM
Sarkom	Krebs	HYPER
Dissonanz	Harmonie	ANT
Optimismus	Pessimismus	ANT
Bindehaut	oculus	PART_OF
Geschirr	Fallschirm	PART_OF
Penny	Pfund	PART_OF
mobilisieren	Rallye	SYN
Ganove	Punk	SYN
Bewohner	Bewohner	SYN
Glauben	Molekül	RANDOM
Spiegel	zeigen	HYPER
Bucht	Flugzeug	PART_OF
sich erinnern	abrufen	SYN
Stil	Weg	SYN
pastorate	Klerus	HYPER
Erhöhung	Tierkreis	PART_OF
Unwahrscheinlichkeit	Wahrscheinlichkeit	ANT
erscheinen	Schnee	RANDOM
Marionette	Zahl	HYPER
Kreuzung	Route	PART_OF
Sandpapier	Schleifmittel	HYPER
bunter	Teig	HYPER
optimistisch	pessimistisch	ANT
Quintett	Montage	HYPER
Fremder	jemand	HYPER
Kortex	optisch	PART_OF
Klammer	Paar	RANDOM
heterozygot	homozygot	ANT
Chlorophyll	Farbe	HYPER
Wolke	mild	RANDOM
Quatsch	Gewäsch	SYN
unbegründet	wild	SYN
Anruf	Schmelze	RANDOM
Intelligenz	Botschaft	HYPER
Knopfloch	Kleidungsstück	PART_OF
Heterogenität	Homogenität	ANT
unterscheidbar	nicht zu unterscheiden	ANT
modern	Tor	RANDOM
Chip	biegen	RANDOM
Mispel	Mispel	PART_OF
Kosmologie	Philosophie	HYPER
Membran	Torso	PART_OF
Pflanzung	Aktivität	HYPER
Warfarin	Medikation	HYPER
Nanometer	Mikrometer	PART_OF
outfox	übervorteilen	SYN
führend	stellar	SYN
Schüssel	Bowling	PART_OF
Bewunderung	Geschmack	HYPER
goop	Schmiere	SYN
Fruchtbarkeit	Unfruchtbarkeit	ANT
Bekanntschaft	Fremder	ANT
Netz	Feder	PART_OF
progressiv	regressiv	ANT
tourer	Tourist	SYN
Fovea	Retina	PART_OF
Herzmuschel	Plätschern	SYN
Nein	ja	ANT
Klinge	Design	RANDOM
Kardinal	Ordinal-	ANT
Anode	Kathode	ANT
heterosexuell	Boden	RANDOM
reserviert	vorbehaltlos	ANT
Axon	Neuron	PART_OF
Vorteil	Molekül	RANDOM
Lüge	faul	RANDOM
Stechen	Welle	SYN
Explosion	entladen	HYPER
tauchen	stürzen	HYPER
Nichtzahlung	Zahlung	ANT
Fingerabdruck	beschädigen	HYPER
Hals	Schraube	RANDOM
ripcord	Rutsche	PART_OF
Irland	Fußboden	RANDOM
Tiefe	Oberflächlichkeit	ANT
Projekt	visualisieren	SYN
Fitness	Untauglichkeit	ANT
Bogen	verringern	HYPER
Pensionierung	gehen	HYPER
gedämpft	gestochen	SYN
Anerkennung	Abschreibung	ANT
Berme	Route	PART_OF
erscheinen	niedrig	RANDOM
gefangen	Absicht	SYN
Ansatz	Nieder	RANDOM
Morphem	Bestandteil	HYPER
spülen	Nervenkitzel	SYN
turd	Ausscheidung	HYPER
Richter	Log	RANDOM
gam	Herde	HYPER
Bett	Grund	RANDOM
Vergangenheit	Deckel	RANDOM
erstklassig	spitzenmäßig	SYN
Komplexität	Einfachheit	ANT
Notfall	Bremse	HYPER
Patriot	National	HYPER
Gesims	Gebälk	PART_OF
Beschleunigung	Verzögerung	ANT
ausdrücken	begrenzt	SYN
Schrittmacher	Modell-	HYPER
bedauerlich	erbärmlich	SYN
nm	Millimeter	PART_OF
Reizung	Provokation	SYN
Rechtswidrigkeit	Rechtmäßigkeit	ANT
verständlich	verständlich	SYN
Schlafgemach	Wohnung	PART_OF
Shake	Artefakt	HYPER
Papier-	Schatten	RANDOM
höhnisch	Respektlosigkeit	HYPER
unwillig	bereitwillig	ANT
Pontifex	ehrwürdig	HYPER
mischen	schreiben	RANDOM
Schnauze	Tier	PART_OF
Zoll	Tempo	PART_OF
Laube	Dorn	SYN
Schlampe	Schwein	HYPER
Spitze	reifen	RANDOM
Meter	Hm	PART_OF
Lebensunterhalt	Leben	HYPER
Taktiker	Planer	HYPER
Lende	Vierfüßler	PART_OF
Thorax	Gliederfüßer	PART_OF
Griot	Erzähler	HYPER
Disinflation	Inflation	ANT
cc	cl	PART_OF
fleer	Verachtung	HYPER
zucken	Bewegung	HYPER
Fall	recyceln	RANDOM
Splatter	Sputter	SYN
Innen-	draussen	ANT
untersuchen	canvass	HYPER
Frieden	Orange	RANDOM
Schön-	Rückseite	ANT
Kreditnehmer	Darlehensgeber	ANT
ein Stück	dreiteilig	ANT
dosieren	behandeln	HYPER
groß	Vertrauen	RANDOM
geschmacklos	lecker	ANT
illegitim	legitim	ANT
pectoralis	Torso	PART_OF
Schnabel	Unglück	RANDOM
Rindfleisch	Teilen	RANDOM
sportlich	Gymnastik-	SYN
Absehen	Okular	PART_OF
Schock	Suspension	PART_OF
akzeptierbar	untragbar	ANT
Pottasche	ätzend	HYPER
Glauben	Sprache	RANDOM
Skrupel	Drachme	PART_OF
Sucher	Umfang	PART_OF
Hallo	Hallo	SYN
Arbeit	hinzufügen	RANDOM
gerissen	schlau	SYN
Sauerstoff	Schritt	RANDOM
Badewanne	Domizil	PART_OF
Film	Transport	RANDOM
Tunnel	Passage	HYPER
Hinweis	Kissen	RANDOM
Kalmus	Kalmus	PART_OF
Telomer	Kern	PART_OF
dankbar	undankbar	ANT
Schärpe	Gebäude	PART_OF
Katalase	Eiweiß	HYPER
Timpani	tympani	SYN
unleserlich	lesbar	ANT
Homosexuelle	Kartoffel	RANDOM
hoch	Tor	RANDOM
Hör mal zu	Griff	RANDOM
Verbündete	Nation	HYPER
weenie	Hotdog	PART_OF
handgesponnen	tweedy	SYN
Schuld	Unschuld	ANT
Penis	Vakuum	RANDOM
Menschheit	Leben	RANDOM
Tafel	Emotion	RANDOM
cl	dl	PART_OF
Quartal	hr	PART_OF
irreligiös	religiös	ANT
klar	Wort	RANDOM
ingenue	Mimin	HYPER
Vorteil	Hut	RANDOM
Fledermaus	Geschenk	RANDOM
sperren	Aufklärung	RANDOM
Sau	Übertragung	HYPER
Spitze	Post	RANDOM
Alfalfa	Luzerne	SYN
Lüge	Fernsehen	RANDOM
Arie	Oper	PART_OF
Sediment	Pose	HYPER
Kapitel	Land	RANDOM
Freund	befestigen	RANDOM
heiß	Panzer	RANDOM
klicken	Ratsche	PART_OF
einwandfrei	makellos	SYN
extrasensory	sensorisch	ANT
Antizyklon	Zyklon	ANT
Armband	Kleidungsstück	PART_OF
Freundlichkeit	Unangenehmheit	ANT
dragnet	planen	HYPER
jucken	itchiness	SYN
hypnotisiert	hypnotisiert	SYN
Kadett	plebe	SYN
Motorhaube	Abdeckung	HYPER
Schublade	Zähler	PART_OF
Kreide	Meth	SYN
Boot	Liebhaber	RANDOM
einmischen	Bruch	HYPER
hokey	matschig	SYN
disgorgement	Aufstoßen	SYN
Objekt	Meer	RANDOM
entwischen	ausweichen	SYN
Band	Lorbeeren	HYPER
Wrack	Missgeschick	HYPER
Anchorage	Hafen	PART_OF
zufrieden	unzufrieden	ANT
erscheinen	edel	RANDOM
bewerten	messen	SYN
Salon	Wohnen	PART_OF
Arithmetik	Brücke	RANDOM
Ruhe	Zutat	RANDOM
Jacke	nett	RANDOM
Demut	Veranstaltung	RANDOM
schrubben	Aufräumen	HYPER
Verschnaufpause	Unter	PART_OF
exogamy	Mischehe	SYN
Pixel	Anzeige	PART_OF
Ahle	Haarnadel	HYPER
mutig	Wasserfall	RANDOM
Schluck	Portion	PART_OF
hoch	Ideologie	RANDOM
Intoleranz	Toleranz	ANT
Annahme	Wange	HYPER
Hupe	Auto	PART_OF
Untreue	Loyalität	ANT
Ansporn	drängen	SYN
Nostalgie	Sehnsucht	HYPER
Sekretär	Assistent	HYPER
faul	hinzufügen	RANDOM
katastrophal	schicksalhaft	SYN
Büro	Möblierung	HYPER
Schluck	Nahrungsaufnahme	HYPER
Dunkelheit	Bedeutung	ANT
mystisch	Okkulte	SYN
Promiscuous	mutwillig	SYN
verhätscheln	verwöhnen	SYN
Gleitgel	Schmiermittel	SYN
Speerspitze	Welle	PART_OF
Schüssel	Blatt	RANDOM
Zwischenspeicher	Stash	SYN
Schlüssel	liefern	HYPER
Reservierung	Zweifel	HYPER
Baluster	Balkon	PART_OF
Hierarchie	planen	PART_OF
Überflutungs	Untertauchen	SYN
Ziffer	Wirbeltier	PART_OF
Süßigkeiten	gleich	RANDOM
Schiefe	Arbeit	PART_OF
Erstickung	Hypoxie	HYPER
behoove	Stichelei	HYPER
Wissen	nett	RANDOM
kc	Megahertz	PART_OF
Ausbeute	zu Verfügung stellen	HYPER
Programm	Botschaft	HYPER
tunny	Thunfisch	PART_OF
geprüft	kariert	SYN
Schicksal	Okkulte	PART_OF
geboren	ungeboren	ANT
gutartig	verleumden	ANT
Schneesturm	Schneesturm	SYN
Hähnchen	Hass	RANDOM
heftig	wütend	SYN
magnetisch	magnetisiert	SYN
Verständnis	Unverständnis	ANT
sich einmischen	Stampfer	SYN
Loch	gelingen	RANDOM
Brief	hoch	RANDOM
Mitglied	Kind	RANDOM
Ansatz	Belohnung	RANDOM
Kennzeichen	verbessern	RANDOM
Overkill	Geburtswehen	HYPER
ovoviviparous	viviparous	ANT
niedriger	Kühler	RANDOM
Frivolität	Schwere	ANT
Hecktür	LKW	PART_OF
unbefugt	wilde Katze	SYN
Feder	Feder	PART_OF
briony	bryony	SYN
Stärke	Klavier	ANT
nachdenklich	gedankenlos	ANT
steril	einfallslos	SYN
Strommitte	Wasserlauf	PART_OF
Optimistin	Pessimist	ANT
erotica	Aktivität	HYPER
Geburtswehen	Schwangerschaft	PART_OF
Gaul	Kick	HYPER
Klugheit	Klugheit	HYPER
Einberufene	gewinnen	HYPER
umkippen	erklären	HYPER
Arabeske	Artefakt	HYPER
Pfund	cwt	PART_OF
Ast	Ignoranz	RANDOM
Grabstein	Spanne	PART_OF
Junge	Bürschchen	SYN
Schokolade	Stück	RANDOM
Verwirkung	Opfern	SYN
begeistert	lustlos	ANT
tragen	entzünden	RANDOM
Trend	Tendenz	HYPER
Pontifikat	verwalten	HYPER
Kamerad	Wasser	RANDOM
Nation	Zeit	RANDOM
feucht	Feuchtigkeit	SYN
Kapitel	Kleid	RANDOM
Tastatur	intelligent	RANDOM
aufregend	nicht aufregend	ANT
Verkleidung	Gebäude	PART_OF
Formalität	Ungezwungenheit	ANT
Fehler	Maus	RANDOM
Eishockey	gleich	RANDOM
vorstellen	erwarten von	HYPER
Benedektiner	Likör	HYPER
Aufzug	Sex	RANDOM
Erwachsene	Fix	RANDOM
Sauerstoff	Bedienung	RANDOM
Höflichkeit	Unhöflichkeit	ANT
beträchtlich	unbedeutend	ANT
präventiv	Medikation	HYPER
Bollwerk	Befestigung	PART_OF
exklusiv	inklusive	ANT
Karte	Poster	SYN
entscheiden	Richter	SYN
Fledermaus	Integrität	RANDOM
Mund	Bleistift	RANDOM
Sprache	Zutat	RANDOM
vielleicht	möglicherweise	SYN
Anstrengung	Geburtswehen	SYN
Schlüssel	Kofferraum	RANDOM
Erinnerung	Lager	SYN
Prat	Torso	PART_OF
Zusatzstoff	subtraktiven	ANT
Unmäßigkeit	Mäßigkeit	ANT
Mitte zwanzig	Reife	PART_OF
Fett	Fleck	SYN
lose	Schatten	RANDOM
Heuschrecke	Heuschrecke	HYPER
beauftragt	noncommissioned	ANT
Knochen	sinnvoll	RANDOM
Audio-	Fernsehsende	PART_OF
Klinik	Krankenhaus	PART_OF
Kügelchen	Kanister	PART_OF
Empfangshalle	bekommen	RANDOM
Atmosphäre	benutzen	RANDOM
Bruder	Schwester	ANT
Elan	Eifer	HYPER
Anker	glattere	PART_OF
Grundbesitz	Besitz	HYPER
Genf	Spirituosen	HYPER
Herzmuschel	knackig	HYPER
Tafel	Scheidung	RANDOM
niemals endend	unaufhörlich	SYN
Organ	Zug	RANDOM
Kauen	Ernährung	PART_OF
kultiviert	kultiviert	SYN
Obdachlosigkeit	Status	HYPER
Transfer	Übertragung	SYN
Wange	caput	PART_OF
entdecken	beachten	SYN
Atemloch	Wal	PART_OF
Verstand	richtig	RANDOM
Prise	Zucken	SYN
sperren	sauer	RANDOM
Kladde	Sachen	HYPER
Millimeter	Zentimeter	PART_OF
weitläufig	weitläufig	SYN
die Genehmigung	Missbilligung	ANT
Nacht-	Miete	RANDOM
feinkörnig	gepulvert	SYN
rückgängig machen	vereiteln	HYPER
Tinte	Ausflug	RANDOM
Joggen	Fröhlich	RANDOM
Galeere	Kunst	HYPER
Achtung	Sicherheit	ANT
zwei Drittel	Fraktion	HYPER
lyrisch	Bolzen	RANDOM
Volley	emittieren	HYPER
Gallone	großes Fass	PART_OF
Schere	Krebs	PART_OF
Boss	Vergangenheit	RANDOM
Strand	Empfangshalle	RANDOM
versöhnlich	unversöhnlich	ANT
Nachwuchs	wild	RANDOM
gebunden	staccato	ANT
wiederholen	untersuchen	HYPER
Destabilisierung	Stabilisierung	ANT
Vertraute	jemand	HYPER
Plastination	Erhaltung	HYPER
Geschichte	Sprache	RANDOM
Karosserie	Gegenstand	RANDOM
unvorsichtig	vorsichtig	ANT
Party	fließen	RANDOM
abscheulich	liebenswert	ANT
formal	informell	ANT
Schokolade	Ring	RANDOM
Klammer	Verspannung	SYN
Keller	erhöhen	RANDOM
Kette	weben	PART_OF
zugewandt	Manschette	PART_OF
Nachdenklichkeit	Ballaststoff	PART_OF
aktiv	tatenlos	ANT
Diagonale	Damebrett	PART_OF
Schaft	Lenker	PART_OF
wechseln	Sicherungskopie	HYPER
Panik	Sorge	HYPER
Schienbein	Kampf	SYN
Ziel	Pfad	HYPER
schielend	fest	SYN
Adjusted	verhaltensgestört	ANT
liebend	lieblos	ANT
Angelegenheit	sehen	RANDOM
zentralisierte	dezentral	ANT
Spezialisierung	Einstellung	HYPER
Wird geladen	Verhältnis	HYPER
blass	löschen	RANDOM
Pädagogie	Methode	HYPER
Boot	Geld	RANDOM
verlängern	linear	SYN
clavier	forte	PART_OF
dicht	verdunkeln	SYN
kompromittierend	kompromisslos	ANT
Einlass	See	PART_OF
Baseball	Platz	RANDOM
gelt	Lutscher	SYN
Gefängnis	Maus	RANDOM
Ganove	Schwerverbrecher	HYPER
ungeöffnete	eingehüllt	ANT
nach innen gerichteten	Außenbord-	ANT
Steigung	Elevation	PART_OF
Brautwerbung	anfordern	HYPER
ft	Tempo	PART_OF
sklavisch	fügsam	SYN
versammeln	stecken	SYN
vorspannen	Konstellation	RANDOM
Motorhaube	Automobil	PART_OF
Unvorsichtigkeit	Klugheit	ANT
Mitte der fünfziger Jahre	Erwachsensein	PART_OF
Depot	Transit	PART_OF
Erektion	Artefakt	HYPER
Ausfallzeit	Betriebszeit	ANT
Hälfte	Gruppierung	HYPER
illegal	legal	ANT
westlich	Wester	HYPER
montieren	Lehm	RANDOM
Unterschied	Gleichheit	ANT
zweckmäßig	zwecklos	ANT
Verfassungs-	verfassungswidrig	ANT
Alter	Lebensdauer	PART_OF
Fledermaus	aufwachen	RANDOM
Steigbügel	Steigbügel	SYN
Berichterstattung	Größe	HYPER
Griffbrett	Laute	PART_OF
Pilot	Motor	PART_OF
lyrisch	Lauf	RANDOM
Entrechtung	enfranchisement	ANT
innere	Innere	SYN
Begeisterung	Neugierde	HYPER
Glauben	Stunde	RANDOM
Pint	Mädel	PART_OF
trice	hissen	HYPER
Musik-	Ring	RANDOM
Schärfe	Humor	HYPER
Geräumigkeit	Geräumigkeit	SYN
Vordenker	orchestrieren	SYN
Vorsichtig	leichtsinnig	ANT
noch vorhanden	ausgestorben	ANT
Torheit	Dummheit	SYN
Allgemeines	besonders	ANT
Präambel	Papiere	PART_OF
frank	Hotdog	PART_OF
Start	Kommunikation	RANDOM
poundage	Aneignung	HYPER
ausweiten und	gehen	HYPER
Kugelfisch	Kugelfisch	PART_OF
unbedeutend	Erdnuss	SYN
legalisieren	legitimieren	SYN
geregelt	unkontrolliert	ANT
Trimester	Schwangerschaft	PART_OF
Blitz	entlarven	HYPER
Babuschka	Kopftuch	HYPER
Pikanterie	Attribut	HYPER
Programm	Lehrplan	SYN
angezapft	unerschlossen	ANT
geringer	bescheiden	SYN
Mensch	Muster	RANDOM
Darsteller	Sicht	RANDOM
Fingerabdruck	Schandfleck	HYPER
unbarmherzig	unmercifully	SYN
Tonne	megaton	PART_OF
schleifen	Maische	SYN
Klerus	Laien	ANT
gewinnen	Verlust	ANT
stolzieren	Zigeuner	HYPER
Sturz	Konvexität	HYPER
Apfel	Führer	RANDOM
abwärts	nach oben	ANT
spornen	drängen	SYN
Füllstoff	Zigarre	PART_OF
klar	bräunen	RANDOM
Verwirrung	Mystifikation	SYN
fruchtbar	fruchtlos	ANT
Pflege	Metall	RANDOM
brennen	Gefängnis	RANDOM
rotierend	Route	PART_OF
Vene	Fleck	HYPER
Rambutan	Rambutan	PART_OF
Mitte	Sprache	RANDOM
hager	Skelett-	SYN
Chip	pflegen	RANDOM
verschieben	verzögern	HYPER
mischen	schreien	RANDOM
abgestumpft	abgestumpft	SYN
Pedal	Strom	RANDOM
integriert	segregierten	ANT
Nanometer	Millimeter	PART_OF
unerreichter Meister	Heilige	SYN
unparteiisch	teilweise	ANT
Redo	umgestalten	SYN
Leck	Pfanne	RANDOM
Blut	Niveau	RANDOM
Kind	fließen	RANDOM
Kandidat	politisch-	HYPER
Eierstock	blühen	PART_OF
gezwungen	angespannt	SYN
mons	Vulva	PART_OF
Vergrößerung	Elevation	SYN
Körperbau	soma	SYN
beschäftigt	Aluminium	RANDOM
Licht	Mineral	RANDOM
Fest	unbefestigt	ANT
Rakete	entstehen	HYPER
Lektion	Lehren	PART_OF
Wirksamkeit	Unwirksamkeit	ANT
genital	venerisch	SYN
Vorfuß	Vierfüßler	PART_OF
Tonic	Getränk	HYPER
beteiligt	unbeteiligt	ANT
talentiert	unbegabt	ANT
Höflichkeit	Haltung	HYPER
vorspannen	hohl	RANDOM
Belastung	burthen	SYN
Sack	Struktur	HYPER
outdoorsman	jemand	HYPER
Waschbär	ringtail	SYN
comer	Wettbewerber	HYPER
Chip	bewirken	RANDOM
Schüssel	Folgen	RANDOM
Zuhause	Reproduktion	RANDOM
Blumenkohl	Blumenkohl	PART_OF
Wintermitte	Winter	PART_OF
Regentropfen	Regenfall	PART_OF
Homosexuelle	Hitze	RANDOM
verschieden	undeutlich	ANT
Gastgeber	interagieren	HYPER
Ohrmarke	zuteilen	HYPER
Winkel	Gebäude	PART_OF
Trockenheit	Nässe	ANT
Rückgewinnung	Wiedergutmachung	HYPER
beklagenswert	Es tut uns leid	SYN
Amateur	Professionel	ANT
Schmerzen	Stift	RANDOM
Verzögerung	inzwischen	SYN
Loch	Menschheit	RANDOM
zerbrechlich	unzerbrechlich	ANT
perinatal	postnatal	ANT
Bar	Oberfläche	RANDOM
Pedal	Elternteil	RANDOM
Vergeltung üben	Rache	SYN
Schnittlauch	Schnittlauch	PART_OF
Beachtung	Unaufmerksamkeit	ANT
nutzbringend	nutzlos	ANT
sesquicentennial	Jahrestag	HYPER
Erbe	Abstraktion	HYPER
weitläufig	zottig	SYN
mehrdeutig	eindeutig	ANT
Sklerose	Pathologie	HYPER
Kern	steigen	RANDOM
Amateur	Professionel	ANT
unmatchable	unerreicht	SYN
Öse	drapieren	PART_OF
Negativität	Positivität	ANT
gebunden	ungebunden	ANT
Hypoxie	Erstickung	PART_OF
Australien	gleich	RANDOM
Bedingung	Experimentieren	PART_OF
Quatsch	sabbern	SYN
mögen	Linie	RANDOM
Stärke	die Schwäche	ANT
Zahlen	Kante	RANDOM
Panorama	ikon	HYPER
durchgedreht	verrückt	SYN
Phantasie	freundlich	RANDOM
Nabel-	Fötus	PART_OF
Elektromagnet	Schaltung	PART_OF
schwatzen	Konversation	HYPER
marc	Brandy	HYPER
voreingenommen	farbig	SYN
jugular	Hals	PART_OF
Infinitesimalrechnung	Mathematik	HYPER
Liesch	Liesch	PART_OF
randlos	mit Rand	ANT
neunziger Jahre	Alter	PART_OF
Säugetier	Brief	RANDOM
Rebound	Basketball	PART_OF
berechnet	ungeladen	ANT
Antworten	Organismus	RANDOM
dorsal	ventrale	ANT
zanken	Gamasche	SYN
hohes Risiko	spekulativ	SYN
Peitsche	oculus	PART_OF
Dreh dich um	Auffahrt	PART_OF
Defensive	beleidigend	ANT
qualifizieren	aussprechen	HYPER
Flosse	Zahl	HYPER
Apfel	Hut	RANDOM
Medizin	Fußboden	RANDOM
Uhr	Mitte	RANDOM
Milligramm	dg	PART_OF
Lunge	erhebt euch	RANDOM
ehemalige	letztere	ANT
pedicel	Stiel	SYN
verletzen	Land	RANDOM
Endstation	Infrastruktur	PART_OF
Streicheln	küssen	SYN
Wissen	Zutat	RANDOM
Agonisten	Gegner	ANT
Klassenarbeiten	Pädagogie	PART_OF
hüpfen	Freund	RANDOM
anregen	stimulieren	SYN
Bogen	Insel	RANDOM
fermi	Angstrom	PART_OF
Nation	Öl	RANDOM
Transplantation	Umpflanzen	SYN
Kick	Sprung	HYPER
verzögern	Überfall	SYN
Eid	Widmung	HYPER
Stammbaum	Abstammung	SYN
Schellfisch	Schellfisch	PART_OF
Magenschmerzen	Dyspepsie	PART_OF
Zusammensetzung	Platzierung	HYPER
Klammer	Rahmen	PART_OF
Entrechtung	enfranchisement	ANT
kultiviert	unkultiviert	ANT
weihen	heiligen	SYN
Schäler	Stripper	SYN
Sintflut	Haufen	HYPER
Plural-	Singular	ANT
Absehen	Ausmalung	SYN
Uhr	Freiheit	RANDOM
bereit	nicht fertig	ANT
Abraten	Überzeugung	ANT
Mut	Schüchternheit	ANT
ganz	intakt	SYN
klicken	Dämmerung	SYN
Minute	Socke	RANDOM
lohnend	undankbar	ANT
Treue	Loyalität	HYPER
streuen	streuen	HYPER
Arzneibuch	Montage	HYPER
Phosphatase	Enzym	HYPER
Strand	krank	RANDOM
Kupplung	hervorrufen	HYPER
Mischung	entsprechen	HYPER
ungeahnte	ungeahnte	SYN
verletzt	unverletzt	ANT
Freund	gewöhnliche	RANDOM
Schaft	Besteck	PART_OF
Kapitel	Monitor	RANDOM
Farbe	Maus	RANDOM
Schönheit	Hässlichkeit	ANT
Schleuse	penstock	PART_OF
Kunststück	brachial	HYPER
1940er Jahre	vierziger Jahre	SYN
absichtlich	unbeabsichtigt	ANT
Impotenz	Potenz	ANT
Tunika	Mantel	HYPER
Schmetterling	Romantik	SYN
Phantasie	Süd	RANDOM
laut	gammelig	SYN
geändert	unverändert	ANT
Kanal	geben	RANDOM
Kirchenschiff	Bereich	HYPER
Ideal	nonsuch	SYN
reorganisieren	organisieren	HYPER
vorspringend	erleichtert	SYN
hohl	Garten	RANDOM
Entwurf	aufbringen	SYN
Bleicher	jemand	HYPER
choroid	optisch	PART_OF
Strom	Kurs	HYPER
Rollbahn	Flugplatz	PART_OF
Stift	Axt	RANDOM
resonant	schallend	SYN
manus	Homo	PART_OF
Streckmuskel	Beugemuskel	ANT
tendinitis	tendonitis	SYN
Ball	schreien	RANDOM
Zusammensetzung	Opus	SYN
Loyalität	Treue	HYPER
Butter	sperren	RANDOM
Tier	Schriftsteller	RANDOM
kritisch	unkritisch	ANT
unangemessen	verhältnismäßig	ANT
China	Fazit	RANDOM
deduktiv	induktiv	ANT
Unabänderlichkeit	Umkehrbarkeit	ANT
Beliebt	unpopulär	ANT
Scan	überfliegen	SYN
mich	Vision	RANDOM
Erwachsene	Schlaf	RANDOM
Milch	gleich	RANDOM
territorial	Miliz	PART_OF
Dekrement	Zuwachs	ANT
markiert	ausgesprochen	SYN
notwendig	nicht notwendig	ANT
Schnurrbart	Bart	PART_OF
Geburtstag	Austausch-	RANDOM
vorrücken	Liebhaber	RANDOM
Hagelkorn	Hagel	PART_OF
informativ	wenig mitteilsam	ANT
Sprosse	Gebäude	PART_OF
hungrig	durstig	ANT
perianth	blühen	PART_OF
bewundern	Text	RANDOM
Disinflation	Inflation	ANT
Bully	Grobian	SYN
Übereinstimmung	harmonisieren	SYN
Vermögenswert	Haftung	ANT
heilig gesprochen	verherrlicht	SYN
copepod	Plankton	PART_OF
Schlacht	das Vieh	RANDOM
Einwand	Verfahren	HYPER
Nörgelei	Nörgelei	PART_OF
Motorhaube	Auto	PART_OF
billig	teuer	ANT
Heuchler	unecht	SYN
Leiste	Lenden	PART_OF
Zahlmeister	Zahler	HYPER
Verschiebung	Hände	PART_OF
bündeln	Garbe	SYN
gehemmt	ohne Hemmungen	ANT
in erster Linie	in zweiter Linie	ANT
Vernichtung	Zerstörung	HYPER
brennen	Kante	RANDOM
Estragon	Würze	HYPER
wässrig	igneous	ANT
boeuf	Ochsen	PART_OF
Gottlosigkeit	Frömmigkeit	ANT
Einsatz	einfügen	HYPER
Pedal	Insel	RANDOM
Japan	Spiel	RANDOM
erblich	patrimonial	SYN
angenehm	unangenehm	ANT
blass	Leise	RANDOM
Vogel	Gegenstand	RANDOM
Konto	bringen	RANDOM
vergrößerte	vergrößert	SYN
Arbeit	wild	RANDOM
Größe	Kleinheit	ANT
asper	Lira	PART_OF
Schließen	Erzählung	PART_OF
Flunder	staffeln	SYN
Morgen	Öl	RANDOM
Intervention	Nicht-Intervention	ANT
kann	Toilette	PART_OF
denkbare	undenkbar	ANT
hängende	droopy	SYN
bekloppt	kooky	SYN
erweitern	Geste	HYPER
stomper	Gehhilfe	HYPER
kassieren	unterwerfen	SYN
Schaft	Anker	PART_OF
Marke	stehlen	SYN
Mantel	Kamin	PART_OF
Zusammensetzung	Substanz	HYPER
Streckmuskel	Beugemuskel	ANT
definiert	nicht definiert	ANT
barbarisch	unzivilisiert	SYN
Bevölkerung	Öffentlichkeit	SYN
Kunst	Streifen	RANDOM
Dame	ganze	RANDOM
höhnisch	spottend	SYN
Retter	jemand	HYPER
Arsch	derriere	SYN
zivilisiert	kultiviert	SYN
Pubertät	Jugend	PART_OF
alewife	alewife	PART_OF
Cyanamid	Verbindung	HYPER
Staubblatt	blühen	PART_OF
Aufzug	Kunststoff	RANDOM
Villa	Kugel	PART_OF
Dame	drücken	RANDOM
zitieren	Kredit	SYN
hohl	Rückseite	RANDOM
Homosexuelle	produzieren	RANDOM
zeitgemäß	nicht der Jahreszeit entsprechend	ANT
unblutig	blutig	ANT
hinter der Bühne	auf der Bühne	ANT
Erweiterung	Flexion	ANT
Dram	Pfund	PART_OF
Treue	Untreue	ANT
doppelt	Single	ANT
anthropomorphe	menschenähnlich	SYN
vorrücken	Honig	RANDOM
militant	Krieg führend	SYN
Bommel	Muff	SYN
vereint	disjunct	ANT
plastron	Kittel	PART_OF
Rüssel	Elefant	PART_OF
bestraft	unbestraft	ANT
DURCHFÜHRER	Verlierer	ANT
pervers	ruchlos	HYPER
Baseball	Ausflug	RANDOM
Trompeter	Schwan	HYPER
Sinn	beachten	HYPER
raffiniert	ungekünstelt	ANT
verwüsten	Geißel	SYN
geknöpft	knöpfte	ANT
Ellbogen	Abdeckung	HYPER
Fender	Automobil	PART_OF
Niveau	Teller	RANDOM
Kalb	Kalbsleder	SYN
Tastatur	Medizin	RANDOM
Demobilmachung	Mobilisierung	ANT
Relais	Schaltung	PART_OF
einschmeichelnd	einschmeichelnde	SYN
Gen	Kern	PART_OF
nicht reduzierbar	reduzierbar	ANT
rätselhaft	astig	SYN
Antritt	Antritt	PART_OF
Laufen	Betrieb	HYPER
neb	Schnauze	PART_OF
Aufzug	Stimmung	RANDOM
Asien	Vermögen	RANDOM
Vergütung	Lohn-und Gehaltsabrechnung	PART_OF
Hilfe	Leben	RANDOM
Arsch	hinter	SYN
Amerika	saugen	RANDOM
heterosexuell	Kissen	RANDOM
in Flammen	ein Feuer	SYN
Arm	Weniger	RANDOM
ausgeruht	müde	ANT
Auflösung	Auflösung	HYPER
Empfangshalle	Schatten	RANDOM
Warenzeichen	registrieren	HYPER
Unschicklichkeit	Richtigkeit	ANT
Orange	Schnee	RANDOM
azyklische	zyklisch	ANT
punning	Witz	HYPER
Bauch	Torso	PART_OF
vorangestellt	Erfolg	ANT
seasonably	ungewöhnlich	ANT
Aufstoßen	Antrieb	HYPER
69	neunundsechzig	SYN
Kodizill	werden	PART_OF
garbanzo	Schote	HYPER
Gitter	Automobil	PART_OF
Zentner	t	PART_OF
wailer	unglücklich	HYPER
entspannt	Tempus	ANT
Antworten	hell	RANDOM
Kopfgeld	Großzügigkeit	HYPER
primär	Transformator	PART_OF
Flugzeug	entzünden	RANDOM
hg	Kilo	PART_OF
schikanieren	schikanieren	HYPER
Insolvenz	Zahlungsfähigkeit	ANT
wörtlich	Tippfehler	SYN
Steißbein	rachis	PART_OF
hohl	Reiten	RANDOM
taconite	Erz	HYPER
nichts	gleich	RANDOM
narthex	Basilika	PART_OF
lindern	beschwichtigen	SYN
Soloauftritt	angehen	PART_OF
vorsätzlich	unüberlegt	ANT
Hafen	Meer	PART_OF
Lärm	Bein	RANDOM
Lenden	Torso	PART_OF
geometrisch	linear	ANT
eddo	Taro	SYN
Brust	Becher	RANDOM
fleißig	fahrlässig	ANT
eiförmig	ovale	SYN
parallel	aufrecht	ANT
Invasion-	invasive	SYN
Appetithappen	Vorspeise	HYPER
Feder	rauben	SYN
Mühlstein	Schrotmühle	PART_OF
Veränderung	überlegen	RANDOM
Fall	Pop	RANDOM
Mikrogramm	mg	PART_OF
bonito	bonito	PART_OF
Eileiter	Gebärmutter	PART_OF
Gesträuch	Bereich	HYPER
gehen	No Go	ANT
erkennen lassen	sagen	HYPER
Widerhaken	Pfeil	PART_OF
reichlich	Angabe	SYN
aufdringlich	unaufdringlich	ANT
Teil	Mädchen	RANDOM
gelöscht	uncleared	ANT
verletzen	Objekt	RANDOM
drohen	Augur	HYPER
Knutschen	Formen	HYPER
Belastung	Ärger	HYPER
prahlen	Krähe	SYN
Iglu	Bruchbude	HYPER
bewundern	Rechnung	RANDOM
Hammerkopf	knucklehead	SYN
Dolmetscher	Software	HYPER
ft	Stange	PART_OF
Innings	Kricket	PART_OF
Klammer	Duo	SYN
Ventilator	Belüftung	PART_OF
Potpourri	Sammelsurium	SYN
Seeteufel	Seeteufel	PART_OF
infektiös	pathogen	SYN
Kondensator	Schaltung	PART_OF
Parser	Compiler	PART_OF
Babysitter	stander	ANT
cps	Kilohertz	PART_OF
verstohlen	offen	ANT
bewaffnet	arm-	ANT
Salon	Aufenthalt	PART_OF
Darstellerin	Schatten	RANDOM
blühen	Jugend	PART_OF
Fortsetzung	Einstellung	ANT
akut	chronisch	ANT
häufig	selten	ANT
Kaufen	Null	RANDOM
vermutlich	ungeahnt	ANT
Ableben	Lebenszeit	PART_OF
sabbern	Sinnlosigkeit	HYPER
verwundet	Gruppierung	HYPER
nett	Teil	RANDOM
Steinbruch	Ziel	SYN
sugarless	süßlich	ANT
Fauna	Flora	ANT
korrupt	ändern	HYPER
Wagenrad	Wagen	PART_OF
ehrgeizig	anspruchslos	ANT
Rappen	Dirham	PART_OF
Dope	Hantel	SYN
Verbindung	jemand	HYPER
bbl	großes Fass	PART_OF
Lunge	Wasserfall	RANDOM
Biege	ruhig	RANDOM
springen	Element	RANDOM
valentine	Schätzchen	HYPER
schändlich	seriös	ANT
beaufsichtigte	unbeaufsichtigt	ANT
Schnabel	Feindseligkeit	RANDOM
Öffnung	optisch	PART_OF
schier	abdrehen	SYN
Experte	tüchtig	SYN
unerreichter Meister	unerreicht	SYN
entwickelt	unentwickelt	ANT
Blues	Volkslied	HYPER
klar umrissen	trimmen	SYN
zwingen	verpflichten	SYN
whirligig	Artefakt	HYPER
verschwommen	unscharf	SYN
Fluke	Gebläse	PART_OF
Arbeitswoche	Woche	PART_OF
Karte	Buchse	RANDOM
lodernd	Ficken	SYN
ciliare	ciliate	SYN
Stall	Shanty	SYN
Fort	stärken	SYN
Holzwolle	Verpackung	HYPER
Formalismus	Nachahmung	ANT
wiedergekäutes Futter	Bündel	SYN
Magenschmerzen	Magenverstimmung	PART_OF
Feindseligkeit	Hass	HYPER
Schlinge	Lasso	PART_OF
fraglich	moot	SYN
Tick	Arachnoidea	HYPER
Calosoma	Käfer	HYPER
Zoll	Pflicht	HYPER
Rekrut	Freiwillige	ANT
Balance	Unausgewogenheit	ANT
Papier-	sitzen	RANDOM
Impotenz	Potenz	ANT
tragen	dribbeln	SYN
Inspiration	Atmung	PART_OF
Verkauf	Handelsgeist	HYPER
Angelegenheit	pflegen	RANDOM
Index	Trennung	RANDOM
bidirektionale	unidirektionale	ANT
schleppen	Trödel	PART_OF
Gumbo	Gumbo	PART_OF
blühen	Wort	RANDOM
Düngung	Anreicherung	HYPER
Feinabstimmung	ändern	HYPER
passel	reichlich	SYN
Schublade	Kommode	PART_OF
hopefulness	Hoffnungslosigkeit	ANT
ungeschrieben	geschrieben	ANT
Minus-	Plus	ANT
üppig	Entsafter	HYPER
Schlehe	Schlehe	PART_OF
Agitation	Ruhe	ANT
Damebrett	Dame	PART_OF
Tektonik	die Architektur	PART_OF
inoperabel	betätigbare	ANT
alphabetisch	alphabetisch	SYN
erstaunlich	übertroffen	SYN
Gemeinde	Bistum	PART_OF
binden	Rock	RANDOM
Nase	Stock	RANDOM
Cent	Rupie	PART_OF
Veränderung	Wolkenkratzer	RANDOM
Index	Gras	RANDOM
Dirham	Riyal	PART_OF
Riss	Spalt	HYPER
lose	Türöffnung	RANDOM
Millimeter	dm	PART_OF
binden	alles	RANDOM
Metaphase	Mitose	PART_OF
erfahren	unerfahren	ANT
altersschwach	gebrechlich	SYN
geplanter Termin	Möblierung	HYPER
versichern	bestätigen	HYPER
isoliert	getrennt	SYN
Homosexuelle	erziehen	RANDOM
schnell	langsam	ANT
Melodie	Melodie	SYN
Erhöhung	Firmament	PART_OF
Schlüssel	Aquädukt	PART_OF
Steifigkeit	Unfähigkeit	HYPER
Krebs	Austausch-	RANDOM
vermuten	Sein	HYPER
Flexibilität	Inflexibilität	ANT
Schaft	Kelle	PART_OF
wilde	jemand	HYPER
Schüchternheit	Selbstzweifel	SYN
Clinch	Griff	HYPER
Unentschlossenheit	Merkmal	HYPER
Punk	blechern	SYN
Plural-	Singular	ANT
Fixierung	Plastination	PART_OF
Cantaloup-Melone	Cantaloup-Melone	PART_OF
Epitop	Antigen	PART_OF
kritzeln	kritzeln	SYN
edda	Taro	PART_OF
sen	Yen	PART_OF
Bogen	verbreitet	RANDOM
Konglomerat	corp	HYPER
Fang	stehlen	RANDOM
Decke	Konflikt	RANDOM
Zivilist	Militär-	ANT
Fehler	Joint	RANDOM
nicht verschreibungspflichtige	Rezept	ANT
Kommode	Toilette	PART_OF
koordinierend	subordinating	ANT
Mord	trocken	RANDOM
Wäscher	Gerät	HYPER
Zittern	Auftreten	HYPER
konstitutiv	organisch	SYN
Film	pic	SYN
Kätzchen	Treffen	RANDOM
Jiu-Jitsu	Selbstverteidigung	HYPER
Monitor	gesund	RANDOM
Neigung	Neigung	SYN
Veränderung	Zug	RANDOM
Tadel	Verweis	SYN
Kohle	Fragment	HYPER
sabbern	begehren	HYPER
gesprächig	geschwätzig	SYN
extravertiert	introvertiert	ANT
Spurt	spritzen	SYN
sich sehnen	sich sehnen	HYPER
Frühreife	Intelligenz	HYPER
insgesamt	total	SYN
Klammer	öffnen	RANDOM
klappern	Besuch	SYN
Pike	thruway	SYN
Schuleschwänzen	Schwänzen	SYN
Apex	Firmament	PART_OF
Flugzeug	Geld	RANDOM
Pathologe	medico	HYPER
Auto	Berg	RANDOM
Mitglied	Reise	RANDOM
Gipfel	Elevation	SYN
Zahlen	Stein	RANDOM
Disziplin	ändern	HYPER
Rittertum	Elite	HYPER
bedingt	bedingungslos	ANT
Tragblatt	Blütenstand	PART_OF
versteckt	untucked	ANT
tatsächlich	Potenzial	ANT
rege	erfrischend	SYN
Kleidungsstück	Kleidung	HYPER
Sicherheitsgurt	Automobil	PART_OF
Kapuze	Flugzeug	PART_OF
Hyperthyreose	Hypothyreose	ANT
Verantwortung	Persönlichkeit	PART_OF
Verstärkung	gewinnen	SYN
Höflichkeit	Unhöflichkeit	ANT
Zapfhahn	Fass	PART_OF
Stabilisator	Leitwerk	PART_OF
Schlecht	Schiff	RANDOM
scheren	schnipp	HYPER
Augmentation	Verminderung	ANT
entmilitarisieren	entkleiden	HYPER
Film	Stift	RANDOM
glühend	virulent	SYN
entbehrlich	unverzichtbar	ANT
Richtigkeit	Unrichtigkeit	ANT
Schneiden	stechend	SYN
Stadt	unbekannte	RANDOM
mieten	echt	RANDOM
perianth	blühen	PART_OF
Plazenta	Gebärmutter	PART_OF
Orthopäde	medico	HYPER
Kunst	Schriftsteller	RANDOM
Maniok	gari	PART_OF
Vergangenheit	Theater	RANDOM
Versand	Handelsgeist	PART_OF
gegenteilig	transponiert	SYN
folktale	Folklore	PART_OF
Blut	Idee	RANDOM
erkunden	diagnostizieren	HYPER
abgetropft	undrained	ANT
Langeweile	leiden	RANDOM
Box	Metall	RANDOM
Abschreckungs	Anreiz	ANT
Unglück	Ereignis	HYPER
aufsteigen	wachsen	RANDOM
Nachwuchs	Aufklärung	RANDOM
aussehen	Ozean	RANDOM
Beitreten	Dach	RANDOM
Kontamination	Dekontamination	ANT
garbanzo	Kichererbse	PART_OF
Fortsetzung	Einstellung	ANT
Selbstsucht	Selbstlosigkeit	ANT
Hör mal zu	Kamin	RANDOM
Klarheit	Opazität	ANT
Führer	Dreieck	RANDOM
Rotor	Kühlschrank	PART_OF
Enttäuschung	eigenartig	HYPER
Kurator	Verteidiger	HYPER
Park	Molekül	RANDOM
Athlet	Aktion	RANDOM
Biege	nichts	RANDOM
bewährt	unbewiesen	ANT
Unabhängigkeit	Stelle	RANDOM
Weichling	Schwächling	HYPER
Brust	wütend machen	RANDOM
Richter	Scheren	RANDOM
Unähnlichkeit	Ähnlichkeit	ANT
Kern	Mark	SYN
tragen	tragen	HYPER
Prachtlibelle	Maid	HYPER
Spur	Länge	HYPER
erwartet	unerwartet	ANT
Geldverleiher	Übeltäter	HYPER
betrügen	Fälschung	HYPER
Atheismus	Theismus	ANT
Halbmond	Monat	PART_OF
Luft-zu-Boden-	Luft-zu-Oberfläche	SYN
verschwenderisch	überschwänglich	SYN
Entlassung	Freisetzung	SYN
Gramm	dag	PART_OF
brainstem	caput	PART_OF
Stammgast	Patron	HYPER
Chor-	Hymne	HYPER
vanda	Orchidee	HYPER
Schaufel	Ruder	PART_OF
tief liegende	Meereshöhe	SYN
Deckel	Schmelze	RANDOM
Silbentrennung	Orthographie	PART_OF
weltfremd	weltlich	ANT
Scheffel	Quartal	PART_OF
zerstört	konserviert	ANT
Missbilligung	Substanz	HYPER
abenteuerlich	abenteuerlich	SYN
broschiert	angehoben	SYN
Schuss	Film	PART_OF
Krankheit	Schrei	RANDOM
reinigen	Freizeit	RANDOM
entschuldigend	unapologetic	ANT
Schweinchen	Ferkel	SYN
Verstärker	kabellos	PART_OF
Kokosnuss	Kokospalme	PART_OF
Nein	Ja	ANT
Fröhlichkeit	Anordnung	PART_OF
Segmentierung	Mutterschaft	PART_OF
Lamelle	o	PART_OF
steigen	Lösung	RANDOM
verstoßen	negieren	SYN
Mord	fließen	RANDOM
Porto	Briefmarke	SYN
Kabel	Telegraph	SYN
laut	Wetter	RANDOM
aktiv	Beitreten	RANDOM
Einbildung	Demut	ANT
verletzt	Design	RANDOM
Stiftung	Erläuterung	PART_OF
drehen	spreizen	SYN
Bar	Riegel	PART_OF
knackig	knusprig	SYN
geozentrisch	heliozentrisch	ANT
Flamme	Fackel	SYN
Sumpf	Lage	HYPER
Rappen	Franc	PART_OF
Richtigkeit	Ungenauigkeit	ANT
unwahrscheinlich	wahrscheinlich	ANT
gefroren	ungefroren	ANT
Kriminalisierung	Entkriminalisierung	ANT
Meerrettich	Meerrettich	PART_OF
bunco	con	SYN
rescript	Schreiben	HYPER
glühen	Lumineszenz	SYN
Hamburger	Hamburger	PART_OF
Pfefferkorn	Pfeffer	PART_OF
erläutern	erarbeiten	HYPER
gesprochen	Wagenrad	PART_OF
aneurin	Thiamin	SYN
Autor	Farbe	RANDOM
Morgen	Studie	RANDOM
nervös	nervös	SYN
Stützpunkt	Hebel	PART_OF
Skrupel	Unze	PART_OF
flehend	Bitten	SYN
Fledermäuse	meschugge	SYN
Fledermaus	schlagen	HYPER
Stock	prügeln	SYN
Segen	Schicksal	HYPER
laut	verbergen	RANDOM
Schaufel	Rakete	PART_OF
kauen	Brief	RANDOM
Schwindel	Benommen	SYN
Japan	Original	RANDOM
erbärmlich	elend	SYN
Party	sehen	RANDOM
Reizbarkeit	Gereiztheit	SYN
stocken	stammeln	SYN
versichern	beruhigen	SYN
hell	Ausruhen	RANDOM
Verklärung	Änderung	HYPER
heilig sprechen	verherrlichen	HYPER
Schamlosigkeit	Widerstandsfähigkeit	HYPER
Klammer	Festsetzung	HYPER
Kiefer	Schraubstock	PART_OF
Borte	Teppiche	PART_OF
realistisch	unrealistisch	ANT
fathead	Gans	SYN
Leibwächter	Suite	PART_OF
Bogen	Gebäude	PART_OF
adorned	schmucklos	ANT
Diebstahl	Verbrechen	HYPER
Schnellgang	übermäßiger Gebrauch	SYN
Fähigkeit	Unfähigkeit	ANT
Feuergefecht	gunplay	SYN
Basic	nebensächlich	ANT
Bär	tragen	HYPER
Basis	Fundament	SYN
blühend	brüllend	SYN
Polster	manus	PART_OF
unterbringen	zu Verfügung stellen	HYPER
ziehen um	immer noch	ANT
Heilige	betrachten	HYPER
Fang	Raum	RANDOM
decumbent	liegend	SYN
Brise	Arbeit	HYPER
Diktator	Potentat	SYN
logrolling	Verdrehung	HYPER
Sturzflug	Beutezug	HYPER
Bock	Pferd	SYN
kaudal	Schädel-	ANT
angemessen	unvernünftig	ANT
Schlitz	Öffnung	HYPER
Verständnis	Unverständnis	ANT
Endometrium	Gebärmutter	PART_OF
ethisch	unethisch	ANT
mutig	Höhle	RANDOM
vernünftig	übermäßig	ANT
Angelhaken	implementieren	HYPER
jubeln	Temperament	PART_OF
verhungern	Durst	SYN
versöhnen	besänftigen	SYN
Phantasie	Gefängnis	RANDOM
Landwirtschaft	Merkantilismus	HYPER
vermuten	Hypothese	SYN
konsistent	inkonsistent	ANT
besonders	Universal-	ANT
Auftrag	Stimmung	RANDOM
beeinträchtigte	unbeeinträchtigt	ANT
lateen	Dhau	PART_OF
Fang	genießen	RANDOM
anfügen	Sofa	RANDOM
Stange	optisch	PART_OF
Pfund	Zentner	PART_OF
Fuchs	Betrüger	HYPER
Scheitelkäppchen	Schädel	PART_OF
zuteilen	aufteilen	SYN
illegitim	legitim	ANT
Direkte	organisieren	SYN
fällig	ungebührlich	ANT
Einstufung	Freigabe	ANT
Cent	Schilling	PART_OF
lunette	Gewölbe	PART_OF
Kutikula	Gliederfüßer	PART_OF
quälend	erschütternd	SYN
natürlich	unnatürlich	ANT
Stoßzahn	tusker	PART_OF
Besen	fegen	SYN
ausgerichtet	nonaligned	ANT
Horn	hässlich	RANDOM
Folgen	Innings	HYPER
Widerhaken	Pfeilspitze	PART_OF
betören	faszinieren	SYN
beschissen	stinkend	SYN
Verstand	Kind	RANDOM
sozialisieren	sozialisieren	SYN
profitabel	unrentabel	ANT
Umlenkblech	Puzzle	SYN
ausrief	Ausruf	SYN
verlieren	Ozean	RANDOM
Überfall	Diebstahl	HYPER
Grobheit	Grobheit	SYN
Schlacht	Himmel	RANDOM
Pünktlichkeit	Verspätung	ANT
hungernd	Entbehrung	HYPER
Spur	Geschirr	PART_OF
Kalb	Star	RANDOM
mischen	Pack	RANDOM
Schlinge	trammel	SYN
löschen	Squelch	SYN
Klamotten	Sahne	SYN
Markt	Professor	RANDOM
belästigen	Mühe	HYPER
Ungeheuerlichkeit	Mutation	HYPER
Vorsitzende	Direkte	HYPER
Gitter	wurmen	SYN
mamey	mamey	PART_OF
hoffnungsvoll	jemand	HYPER
Tasche	Kindermädchen	PART_OF
beschäftigt	Spieler	RANDOM
Kaufen	Zauber	RANDOM
Gipfel	Kegel	PART_OF
fluting	Impressum	HYPER
Gerechtigkeit	Ungerechtigkeit	ANT
Trottel	jemand	HYPER
zocken	Investition	HYPER
formal	inoffiziell	ANT
angenehm	unangenehm	ANT
Hör mal zu	Ozean	RANDOM
zweijährig	zwei Jahre	SYN
Radius	Zyklus	PART_OF
Einrichtung	Regime	PART_OF
Stoma	Tracheotomie	PART_OF
Umfrage	Homo	PART_OF
Sprosse	Leiter	PART_OF
schwarz	Nuss	RANDOM
verwalten	administrieren	SYN
Gehege	Schreiben	HYPER
Auftrag	Garten	RANDOM
Anfänger	Anfänger	SYN
klondike	Solitär	HYPER
Zwerg	Fee	HYPER
Erz	Krone	PART_OF
hoch	Auto	RANDOM
Unfall	Radio	RANDOM
Ausgangspunkt	Anfang	HYPER
Körperbau	Homo	PART_OF
arbeitsam	Arbeit	HYPER
glücklich	traurig	ANT
Diagonale	abfallend	SYN
halb	Ausrüstung	PART_OF
Schinderei	stapfen	SYN
Annahme	Glaube	SYN
Medizin	hell	RANDOM
Traufe	Gebäude	PART_OF
ziehen um	unbewegt	ANT
Gurt	Verschiebung	PART_OF
Geburt	Joint	RANDOM
Artillerie	Rüstung	HYPER
Fibrose	Pneumokoniose	PART_OF
Verwaltung	Regierung	PART_OF
interessiert	uninteressiert	ANT
gook	Schleim	SYN
Strand	Fahrzeug	RANDOM
Mitglied	Transport	RANDOM
Kredite	pic	PART_OF
bod	Chassis	SYN
Widerstand	Schaltung	PART_OF
Box	Korn	RANDOM
mutterrechtlich	patriarchalisch	ANT
heilbar	unheilbar	ANT
Badezimmer	unbekannte	RANDOM
Richtungs-	Rundstrahl-	ANT
Kerl	feller	SYN
drosseln	Auto	PART_OF
Kapitel	zerstören	RANDOM
Bibliothek	Hahn	RANDOM
gähnen	Gähnen	SYN
Reißverschluss	Kittel	PART_OF
Muse	reflektieren	SYN
Vorderseite	Feld	PART_OF
Zorn	sauer	RANDOM
schlummern	Status	HYPER
Fahrrad	biegen	RANDOM
Klinge	Zauber	RANDOM
Wird geladen	Entladung	ANT
Nähen	Stitching	SYN
Muss	Ding	HYPER
Arbeit	Schwangerschaft	PART_OF
Agrar-	Landwirtschaft	SYN
unten	nach oben	ANT
Gerechtigkeit	Ungerechtigkeit	ANT
nm	Millimeter	PART_OF
Nabel	Venter	PART_OF
abstinent	jemand	HYPER
schlagen	Tat	HYPER
Defizit	Besitz	HYPER
kategorisiert	kategorisiert	SYN
basteln	Zigeuner	HYPER
Brotkorb	Bauch	SYN
Vorfall	Folge	PART_OF
Behälter	erfüllen	RANDOM
Rotor	Rutscher	PART_OF
Klappen	Flugzeug	PART_OF
Ruhe in Frieden	Öffnung	HYPER
Virtuosität	Fähigkeit	HYPER
Tomate	Tomate	PART_OF
sculpt	Skulptur	SYN
Unverwundbarkeit	Verletzlichkeit	ANT
jak	Jackfrüchte	PART_OF
Zivilisation	schreiben	RANDOM
Atonalität	Tonalität	ANT
fünfziger Jahre	Erwachsensein	PART_OF
Autoklaven	desinfizieren	HYPER
Fontanelle	braincase	PART_OF
Kapitel	halt	RANDOM
Kortex	Mark	ANT
Rechnungsprüfer	Hörer	SYN
dreißiger Jahre	Erwachsensein	PART_OF
Bestimmer	Erkenntnis	HYPER
Untertreibung	Substanz	HYPER
Verzweiflung	Hoffnung	ANT
anionische	kationische	ANT
Nase	nicht gefallen	RANDOM
Taucher	Seetaucher	SYN
Borke	Zucker	RANDOM
Umnachtung	Unwucht	SYN
Verzweigung	Forking	PART_OF
Kolon	Bewässerung	HYPER
Identität	Erinnerung	HYPER
Fräulein	Reiten	RANDOM
Gang	verlassen	RANDOM
Hirnverbranntheit	Sinnlosigkeit	HYPER
Düse	Schnauze	SYN
Erweiterung	Ergänzung	SYN
vorspannen	Ehefrau	RANDOM
bombardieren	verdrängen	HYPER
Freund	Wagen	RANDOM
Laune	Monster-	SYN
abdominal	Torso	PART_OF
Gerät	Gerät	SYN
Ethik	Philosophie	HYPER
Fettkloß	Fettsack	SYN
Organisation	Regierung	PART_OF
unbeständig	permanent	ANT
Scoop	Bagger	PART_OF
Richter	aufwachen	RANDOM
Künstler	Studie	RANDOM
Säkularisation	Säkularisierung	SYN
ordnen	zustimmen	HYPER
Größe	Kleinheit	ANT
Zusatz	Subtraktion	ANT
Ruhe	Schmerzen	RANDOM
Watt	Pferdestärke	PART_OF
Ansatz	Bestrafung	RANDOM
binaurale	Mono	ANT
Öffnung	Lithosphäre	PART_OF
enttäuschend	climactic	ANT
emptor	vendee	SYN
Homoerotik	Homosexualität	SYN
Baby	Gerade	RANDOM
Verb	Verb	PART_OF
schreien	Äußerung	HYPER
Joint	Fix	RANDOM
Interpunktion	Orthographie	PART_OF
Umstellung	Übergang	SYN
Betrug	Schwindel	SYN
Rekrut	Freiwillige	ANT
Wissen	Notation	HYPER
Leiden	Elend	HYPER
passen	Geschäftsperson	HYPER
entmutigen	warnen	SYN
Klaue	Krebs	PART_OF
sprühen	Jet	HYPER
Kreuz	Hybridisation	SYN
Choke	Flugzeug	PART_OF
Taxi	Taxi	SYN
Klingeln	Klangfülle	SYN
bedingt	unbedingt	ANT
Schlüssel	Stunde	RANDOM
Poem	klimpern	SYN
Säure	Säure	SYN
empfänglich	unempfänglich	ANT
Biom	Gemeinschaft	HYPER
Hohlheit	Solidität	ANT
Glücklich	unglücklich	ANT
Griffel	Grammophon	PART_OF
unsicher	sichern	ANT
Bauer	Arbeiter	HYPER
insgesamt	vollständig	SYN
lernen	wild	RANDOM
Bewältigungs	Gebäude	PART_OF
Tinktur	Farbe	HYPER
aufgeregt	gerührt	SYN
Hähnchen	Geschäft	RANDOM
Ausgabe	Ausgabe	HYPER
stationäre	ambulant	ANT
Matratze	Schlafgemach	PART_OF
vereiteln	Schlauchboot	PART_OF
hoffnungsvoll	viel versprechend	SYN
Gefängnis	Würfel	RANDOM
Elternteil	füllen	RANDOM
Zentimeter	m	PART_OF
Kennzeichen	erstellen	RANDOM
Leben	Strahl	RANDOM
unzureichend	ausreichend	ANT
Fahrrad	Bedienung	RANDOM
Versprechen	Notlage	SYN
Sektor	Wirtschaft	PART_OF
Portion	Mahl	PART_OF
Prügel	whacking	SYN
Affinität	Verwandtschafts	ANT
pst	unterwerfen	HYPER
treibend	wunderlich	SYN
Garnele	Garnele	PART_OF
verschwinden	vorrücken	HYPER
soma	jemand	PART_OF
Musik-	Fahrzeug	RANDOM
Gang	Metall	RANDOM
Folge	Film	PART_OF
hinter der Bühne	auf der Bühne	ANT
distributary	Nebenfluss	ANT
Auslöschung	Schwangerschaft	PART_OF
Brust	echt	RANDOM
Nützlichkeit	Nutzlosigkeit	ANT
tuatara	Reptilien-	HYPER
verbunden	nicht verwandt	ANT
Steckdose	o	PART_OF
Zivilisation	Scharf	RANDOM
treu	untreu	ANT
China	Gruppe	RANDOM
Zusammenstellung	Sammel-	SYN
Dämmerung	Abend	PART_OF
Zügel	Geschirr	PART_OF
Bewegung	Zimmer	RANDOM
tief	oberflächlich	ANT
Annahme	Anordnung	HYPER
Justiz	Regierung	PART_OF
Spülen	Waschen	PART_OF
Leben	Start	RANDOM
Nichtverbreitung von Atomwaffen	Proliferation	ANT
dm	Damm	PART_OF
Unabhängigkeit	Bewegung	RANDOM
pubis	Hüfte	PART_OF
Nanometer	Mikron	PART_OF
Aufmerksamkeit	Unaufmerksamkeit	ANT
Marihuana	Hanf	PART_OF
Balance	verkaufen	RANDOM
Treue	Untreue	ANT
verzückt	rhapsodisch	SYN
Dornbusch	erica	HYPER
zugewiesen	unassigned	ANT
sterbend	Lebensdauer	PART_OF
Sextant	Umfang	PART_OF
kurus	Lira	PART_OF
Lärm	Fernsehen	RANDOM
Ball	Schemel	RANDOM
Justiz	Regime	PART_OF
Bevorzugung	Bevorzugung	SYN
Schleifer	hoagy	SYN
kubisch	planar	ANT
gehen	entscheiden	HYPER
Knauf	stehlen	PART_OF
entwickeln	Ursache	HYPER
alt	reinigen	RANDOM
Polsterung	Artefakt	HYPER
Ehrlichkeit	Kasse	RANDOM
Irland	Professor	RANDOM
entweihen	verletzen	SYN
glaubwürdig	unglaublich	ANT
Christian	stehlen	RANDOM
Imprinting	Erwerb	HYPER
Cockpit	Flugzeug	PART_OF
anständig	anständig	SYN
Renovierung	Verbesserung	HYPER
Gurt	Unterkleid	PART_OF
vergleichbar	unvergleichlich	ANT
Popularisierung	Degradierung	HYPER
Tracht Prügel	Korrektur	HYPER
Bejahung	Umkehrung	ANT
vorspannen	Menge	RANDOM
brüderlich	identisch	ANT
einfach	well-off	SYN
Gegen	ipsilateral	ANT
Rettich	Rettich	PART_OF
Fänger	Befreier	ANT
smiler	Homo	PART_OF
Esslokal	Gebäude	HYPER
100.	Hundertstel	SYN
Begriff	Vorschlag	PART_OF
Eis	unzufrieden	RANDOM
muscadine	muscadine	PART_OF
deklarative	fragend	ANT
autologe	homolog	ANT
protzig	anspruchslos	ANT
zeremoniell	zwanglos	ANT
glänzen	Ereignis	HYPER
Portion	Einheit	PART_OF
Kanalisation	Infrastruktur	PART_OF
Mailer	Inserat	HYPER
Ritter	vorrücken	HYPER
innere	nach außen	ANT
regieren	entscheiden	HYPER
Richtigkeit	Unrichtigkeit	ANT
oben	Buchse	PART_OF
oculus	caput	PART_OF
beharren	erhalten	HYPER
links stricken	verschönern	HYPER
Quartal	Zeitraum	HYPER
Zorn	nichts	RANDOM
Riss	Bruch	SYN
Elternteil	Freundlichkeit	RANDOM
rebury	verdrängen	HYPER
Baby	Stift	RANDOM
Hymne	verherrlichen	HYPER
Riss	Druckknopf	SYN
künstlich	unwirklich	SYN
Neuausgabe	Transfer	HYPER
Runway	Eisenbahn	PART_OF
Erstarrung	Plastination	PART_OF
amnesiac	jemand	HYPER
Wohnung	falsch	RANDOM
Zuverlässigkeit	Unzuverlässigkeit	ANT
scheußlich	schrecklich	SYN
Cannabis	Krug	RANDOM
vergrößern	vergrößern	SYN
beschränkt	invasive	ANT
Ast	Post	RANDOM
Irland	Mond	RANDOM
Vollendung	Ende	HYPER
widerlich	widerwärtig	SYN
unerlaubt	erlaubt	ANT
Heil	Lieferung	HYPER
entscheidend	unentschlossen	ANT
wasserfrei	wasserhaltig	ANT
Intellekt	jemand	HYPER
Kitz	katzbuckeln	SYN
Unmäßigkeit	Mäßigkeit	ANT
agitieren	einladen	HYPER
stolz	Triumph-	SYN
ungewürzt	ungetestet	SYN
Übertreibung	Untertreibung	ANT
geräuschvoll	ruhig	ANT
Nachahmung	simuliert	SYN
Spitze	Kegel	PART_OF
Badezimmer	Musik-	RANDOM
Unschicklichkeit	Richtigkeit	ANT
Arm	Reich	ANT
rachis	Stengel	HYPER
Blendung	blendend	SYN
Zeitschrift	Verwahrstelle	HYPER
Runway	Flugplatz	PART_OF
Verstärker	Modifikator	HYPER
Schaft	Spatel	PART_OF
Menopause	Reife	PART_OF
Bolero	terpsichore	HYPER
Erstickung	Ende	HYPER
wirksam	ineffectually	ANT
Anchorage	Oase	PART_OF
entgegenwirken	zersetzen	SYN
Befestigungen	Nährstoff	HYPER
kratzen	löschen	HYPER
Streuung	Aktivität	HYPER
aufsteigen	Glauben	RANDOM
Defekt	beschädigen	SYN
Hypertonie	Unterdruck	ANT
extramural	intramurales	ANT
verlangsamen	verringern	HYPER
Masse	Chaos	SYN
farrago	Mischmasch	SYN
bescheinigt	uncertified	ANT
Hertz	Megahertz	PART_OF
Chip	Ventilator	RANDOM
Mann	Topf	RANDOM
choroid	oculus	PART_OF
Quartal	Oberer	PART_OF
Mund	Löschen	RANDOM
Antlitz	Homo	PART_OF
familial	genetisch	SYN
Gerät	Vermittlung	HYPER
eddo	Taro	PART_OF
Zuneigung	Stock	RANDOM
Arbeiten	Artefakt	HYPER
einweichen	Beschwichtigungsmittel	SYN
Leben	Gegenstand	RANDOM
diachronen	synchron	ANT
China	Haustier	RANDOM
objektiv	subjektiv	ANT
Defätist	Skeptiker	HYPER
Gitter	Auto	PART_OF
Dämmerung	Abendzeit	PART_OF
Flegel	jemand	HYPER
Zentner	Tonne	PART_OF
Eintauchen	Bedeckung	PART_OF
Achtung	Artefakt	HYPER
Verteilung	Marketing	PART_OF
Attrition	Anstrengung	HYPER
weniger	Mehr	ANT
Knospe	sprießen	HYPER
Nachrichten	Topf	RANDOM
Primitive	jemand	HYPER
anisotropen	isotropen	ANT
erdgebunden	prosaisch	SYN
Kapitalismus	Sozialismus	ANT
Interdikt	Edikt	HYPER
Schnabel	Bitte	RANDOM
Debüt	Einführung	SYN
Härte	Weichheit	ANT
wertend	unvoreingenommen	ANT
Morgen	Tageszeit	PART_OF
Griffon	Geier	HYPER
Hafen	Krankenschwester	SYN
Schalotte	Schalotte	PART_OF
Hochzeit	Zeremonie	HYPER
Schlafzimmer	sinken	RANDOM
stetig	unsicher	ANT
keine Besprechung	verleihen	SYN
Konzeption	Missverständnis	ANT
Stuhl	Trennung	RANDOM
nett	hässlich	RANDOM
Griff	Dolch	PART_OF
kreisförmig	rotierend	SYN
Mahagoni-	Sepia	SYN
ermitteln	prüfen	SYN
alt	Huf	RANDOM
Badewanne	Wohnen	PART_OF
Transvestit	Sein	HYPER
gedimmt	undimmed	ANT
Souffleur	Assistent	HYPER
tamarindo	tamarindo	PART_OF
Kanal	Dienen	RANDOM
offing	Main	PART_OF
Physiognomie	Homo	PART_OF
Straßenrand	Transit	PART_OF
Schlüssel	Arkade	PART_OF
Dicke	Dünnheit	ANT
trainiert	ungeschult	ANT
anterograde	rückläufig	ANT
Rüssel	Mammut-	PART_OF
Schiefe	Mutterschaft	PART_OF
Überfülle	Menge	HYPER
Mittelfeld	Außenfeld	PART_OF
Garantie	billig	HYPER
Hierarchie	Führung	PART_OF
Rüstung	Abrüstung	ANT
Schriftart	Graphem	HYPER
schmettern	blasen	SYN
Klammer	Reproduktion	RANDOM
Ärger	Rauferei	SYN
Schlüpfer	unaussprechlich	HYPER
Laufen	Arbeiten	SYN
Wirtschaft	Gruppierung	HYPER
balsamisch	verrückt	SYN
Metaphysik	Geisteswissenschaften	HYPER
begeistert	entranced	SYN
mischen	Straße	RANDOM
Erziehung	Erbe	HYPER
Box	Bus	RANDOM
Minister	Stock	RANDOM
Separatist	jemand	HYPER
Konservatorium	Gebäude	HYPER
Interpolation	Zwischen	SYN
privilegiert	unterprivilegiert	ANT
Banalität	Bromid	SYN
Schaft	Wasserhahn	PART_OF
Freundlichkeit	Unangenehmheit	ANT
Darstellerin	Ehepartner	RANDOM
Kapuze	Kamera	PART_OF
Lee-	windwärts	ANT
sartor	Schneider	SYN
abstrakt	konkret	ANT
Leck	Gewehr	RANDOM
Kilohertz	Megahertz	PART_OF
gunstock	Batterie	PART_OF
beidhändig	linkshändig	ANT
stottern	Kampf	SYN
Blatt	Nische	RANDOM
körperlich	somatisch	SYN
Generalist	Spezialist	ANT
Nichtraucher	Raucher	ANT
Sog	Strom	HYPER
Bejahung	Umkehrung	ANT
Zahl	Boden	ANT
Vermarkter	vender	SYN
Fall	Fernsehen	RANDOM
Popularität	Unbeliebtheit	ANT
groß	verbreitet	RANDOM
Kunst	Stolz	RANDOM
geschmeidig	wächsern	SYN
Landung	Treppe	PART_OF
Herstellung	Frage	RANDOM
Künstler	leiden	RANDOM
Futter	Drehbank	PART_OF
Trampel	Grassamen	SYN
Grobian	Übeltäter	HYPER
Anstand	Unanständigkeit	ANT
justiciary	Schiedsrichter	HYPER
adjacency	Kontiguität	SYN
Lunge	Mut	RANDOM
bestehen	spucken	RANDOM
abgespannt	verkniffen	SYN
unerschrocken	unerschüttert	SYN
Unwilligkeit	Bereitschaft	ANT
Entschädigung	Restitution	SYN
Stärkung	Schwächung	ANT
Querschiff	Kirche	PART_OF
Rassel	Klapperschlange	PART_OF
cathedra	Dom	PART_OF
Minderwertigkeit	Überlegenheit	ANT
unterdrücken	Nessel	HYPER
Fleisch	solide	RANDOM
Entlassung	Befreiung	SYN
Verkauf	Großhandel	ANT
biggin	Kopfschmuck	HYPER
Fitness	Kompetenz	HYPER
Unze	Pfund	PART_OF
frischere	under	HYPER
Selbstsucht	Selbstlosigkeit	ANT
kann	eingeweiht	PART_OF
Schürze	Theater	PART_OF
hypnotisiert	gebannt	SYN
Badezimmer	absteigen	RANDOM
abgelegen	sequestriert	SYN
Bombenzielvorrichtung	Sehenswürdigkeiten	HYPER
Blitz	knallig	SYN
Gegengewicht	abweichen	HYPER
Inhalt	Veröffentlichung	PART_OF
Kontraktion	Erweiterung	ANT
so	thusly	SYN
Provokateur	Agent	HYPER
Bequemlichkeit	Gerät	SYN
Nähe	Nähe	SYN
Parole	Freisetzung	HYPER
Stapel	Pose	HYPER
Wirksam	wirksam	SYN
Angstrom	Mikrometer	PART_OF
nettlesome	gereizt	SYN
maximal	minimal	ANT
Ethik	Moral	SYN
Gürtel	kennt	RANDOM
Brotfrucht	Brotfrucht	PART_OF
fruchtbar	steril	ANT
Spindel	Portion	HYPER
Plakat	Poster	SYN
Bewegung	Nachwuchs	RANDOM
Magnetzünder	Zündung	PART_OF
männlich	berühren	RANDOM
verletzen	ankommen	RANDOM
Rotor	Stator	ANT
Pflügen	Landwirtschaft	PART_OF
Centavo	sucre	PART_OF
Rückenlehne	Automobil	PART_OF
Festnahme	Halt	SYN
Ballaststoff	jemand	PART_OF
Sublimat	sublimieren	SYN
unglaubwürdig	plausibel	ANT
Tempo	Achtelmeile	PART_OF
sparsam	verschwenderisch	ANT
Traversal	Skifahren	PART_OF
geistig	physikalisch	ANT
Gerechtigkeit	Ungerechtigkeit	ANT
Verstand	Selten	RANDOM
Entwicklung	Entwicklung	SYN
verloren	breit	SYN
Gebäck	Torso	PART_OF
verteilen	blank	HYPER
phantasierend	aufgeregt	SYN
Auftrag	krank	RANDOM
tot	Leben	ANT
Sonnenbrand	Erythem	HYPER
Flüssigkeit	Tor	RANDOM
galant	anschwellen	SYN
fegen	Gewirr	SYN
Gehirn	Film	RANDOM
Kriminalisierung	Führung	HYPER
vergoldet	golden	SYN
kenntnisreich	beschriftet	SYN
männlich	Stein	RANDOM
Kreis	reinigen	RANDOM
Bein	Film	RANDOM
Kritik	Kritik	SYN
Bewegung	Erwachsene	RANDOM
Kenntnisnahme	Studium	SYN
analytisch	Synthetik	ANT
Monotheismus	Polytheismus	ANT
angetriebene	unpowered	ANT
Verdauung	Lernen	HYPER
Neutrino	lepton	HYPER
Feld	Arena	PART_OF
Engagement	Krieg	PART_OF
Rotor	Turbine	PART_OF
hell	Ehefrau	RANDOM
ummantelte	unsheathed	ANT
boeuf	kine	PART_OF
schätzen	vermuten	SYN
mehr	geringer	ANT
druthers	Alternative	HYPER
sechziger Jahre	Alter	PART_OF
gluteus	Torso	PART_OF
Ende	Erzählung	PART_OF
kongruent	inkongruent	ANT
Indikator	Offizier	HYPER
Synapse	Nerv	PART_OF
Heften	Braten	PART_OF
supercilium	caput	PART_OF
Direkte	umgekehrt	ANT
einberufen	einberufen	SYN
lokal	National	ANT
Hochland	Flachland	ANT
Epilog	Schreiben	PART_OF
akzeptierbar	ziemlich	SYN
Bolzen	Kopf	RANDOM
unverweslich	verderblich	ANT
betrügen	Ernte	RANDOM
Unbeständigkeit	Dauerhaftigkeit	ANT
Stator	Turbine	PART_OF
Zelle	Gras	RANDOM
vorrücken	verunreinigen	RANDOM
Annahme	anerkennend	HYPER
Verspritzen	Sputter	SYN
Störung	Störung	SYN
Ader	Mark	SYN
taumeln	Spielplatz	PART_OF
ausbaggern	Bagger	PART_OF
unwirklich	wesentlich	ANT
Welle	Säule	PART_OF
Schmerzen	Mann	RANDOM
Resonanzboden	Klavier	PART_OF
Projekt	Aufgabe	SYN
Mitte der siebziger Jahre	Jahre	PART_OF
zentralisieren	konzentrieren	SYN
positiv	Negativ	ANT
Pedal	Welle	RANDOM
begleiten	Retter	HYPER
Tiro	Anfänger	SYN
versengen	versengen	SYN
schön	Sitz	RANDOM
Bar	Minute	RANDOM
Aussicht	analysieren	HYPER
vertreiben	Freisetzung	SYN
begraben	unburied	ANT
monger	Händler	SYN
Weihe	Engagement	HYPER
abschreckende	überzeugend	ANT
Fürstentum	Region	HYPER
Strukturalismus	Soziologie	PART_OF
Kanal	Möbel	RANDOM
auslassen	beseitigen	HYPER
Gemurmel	Aussprache	HYPER
in Maßen	ziemlich	SYN
finster	mürrisch	SYN
Konsum	Kooperative	SYN
Adhäsion	Bindung	SYN
Wippe	Spielplatz	PART_OF
Gürtel	faul	RANDOM
Wimper	Augenlid	PART_OF
Vogel	rein	RANDOM
Gehalt	Lohn-und Gehaltsabrechnung	PART_OF
Party	Antworten	RANDOM
Hierarchie	Regime	PART_OF
Spitze	sterben	RANDOM
verdammt	wiederherstellen	HYPER
funktional	organisch	ANT
achtsam	sorglos	ANT
formulieren	ausdrücken	HYPER
Allgemeines	Universal-	SYN
schreiten	Gehen	PART_OF
bod	soma	SYN
bumsen	Jazz	SYN
Flugzeug	Hälfte	RANDOM
Hierarchie	Organisation	PART_OF
Vorrichtung	heilen	SYN
groß	frei	RANDOM
Blut	Abstammung	SYN
Wahnsinn	geistige Gesundheit	ANT
vibrieren	hervorrufen	HYPER
Vorteil	freundlich	RANDOM
Humanist	befürworten	HYPER
Cent	Gulden	PART_OF
Hintern	Torso	PART_OF
letzte	tiefste	SYN
diskriminieren	unterschiedslos	ANT
Mikrometer	Zentimeter	PART_OF
Torbogen	Gebäude	PART_OF
undefinierte	gut definierte	ANT
Fuchs	Fell	HYPER
Vogel	erfolgreich	RANDOM
hacken	demütigen	RANDOM
entmutigend	ermutigend	ANT
zügellos	gemäßigt	ANT
Lebensstil	Weg	HYPER
Kurs	Kurs	PART_OF
Gitter	Akkumulator	PART_OF
Salamander	Amphibie	HYPER
Unterarm	Arm	PART_OF
Hering	Hering	PART_OF
schmusen	schmiegen	SYN
linkisch	reizlos	SYN
Blindheit	Beeinträchtigung	HYPER
Entschieden	Unentschlossenheit	ANT
Vorhalle	Gebäude	PART_OF
über	unten	ANT
Kompaktheit	Dichte	SYN
Amerika	Hafen	RANDOM
Klasse	Bedienung	RANDOM
Ungehorsam	Gehorsam	ANT
Schwesternschaft	Organisation	HYPER
Wagen	Mechanismus	HYPER
bestechlich	käuflich	SYN
überschwänglich	gushy	SYN
Namen	Verunglimpfung	HYPER
Träger	immun	HYPER
Dünger	Sachen	HYPER
Sojabohne	Soja	PART_OF
Penis	Stunde	RANDOM
Base	Rohr	RANDOM
korpulent	gewichtig	SYN
Schiene	Balkon	PART_OF
Eishockey	Liebling	RANDOM
Rollbahn	Feld	PART_OF
Glut	zu Verfügung stellen	HYPER
Entwurf	Ziehen	HYPER
Huf	Huftier-	PART_OF
verliebte	vernarrt	SYN
gehen	buchstabieren	SYN
rötlich	scharlachrot	SYN
Ausnahme	Beispiel	HYPER
Geländer	bannister	PART_OF
begrenzt	Besondere	SYN
Pedal	Minute	RANDOM
Zertifizierung	Genehmigung	HYPER
Schmalz	irreführen	HYPER
Platzanweiser	offiziell	HYPER
Tierkreis	Himmel	PART_OF
Verknüpfung	nichts	RANDOM
abdominal	Bauch	PART_OF
ziehen	Weg	SYN
Unmöglichkeit	Möglichkeit	ANT
autorisiert	unbefugt	ANT
Koala	Opossum	HYPER
Milch	bewölkt	RANDOM
Meter	metrisch	HYPER
verdammt	Scheffel	HYPER
Stimulation	Stimulus	SYN
Stuhl	Bleistift	RANDOM
Baluster	Geländer	SYN
mich	Natur	RANDOM
Kammer	Domizil	PART_OF
Abstufung	Wertung	SYN
Adagio	Duett	PART_OF
Scherz	Lerche	SYN
bunco	türken	SYN
Promenade	schlendern	SYN
mieten	Fazit	RANDOM
verständlich	unverständlich	ANT
episodisch	gelegentlich	SYN
Bohnenkraut	widerwärtig	ANT
springen	verlassen	RANDOM
Nachbrenner	Turboprop	PART_OF
Geburt	Übung	RANDOM
Gefolge	Gefolge	SYN
Kampf	Kampf	HYPER
Faulheit	Faulheit	HYPER
Gürtel	Süss	RANDOM
unehrlich	ehrlich	ANT
Deserteur	Renegat	SYN
zehn	tenner	SYN
attraktiv	unattraktiv	ANT
Höhepunkt	Gipfel	SYN
einfach	betucht	SYN
Schokolade	Mitglied	RANDOM
Einkauf	Kauf	HYPER
Schmerzen	glücklich	RANDOM
Größe	Pracht	SYN
Keller	Zehe	RANDOM
schräg	aufrecht	ANT
Mieder	Kittel	PART_OF
scheuern	ärgern	SYN
alltäglich	abgedroschen	SYN
Abenteuer	Mode	RANDOM
vergewaltigen	Verstoß	SYN
mütterlich	väterlich	ANT
Ursprung	Quelle	HYPER
jati	Schicht	HYPER
Kopfstütze	Automobil	PART_OF
billig	Sanktion	HYPER
Base	Kopf	RANDOM
kompetent	inkompetent	ANT
Tush	Torso	PART_OF
casbah	kasbah	SYN
Pamphlet	Travestie	SYN
Friedlichkeit	Ruhe	HYPER
gewissenhaft	gewissenhaft	SYN
Reservieren	Vorrat	SYN
hoch	Auftrag	RANDOM
Geburtsort	Wiege	SYN
Goldgrube	Geschenk des Himmels	SYN
erzählen	gewichtig	SYN
überparteiliche	Partisan	ANT
lyssa	Tollwut	SYN
Rakete	Projektil	PART_OF
ungehorsam	gehorsam	ANT
groß	Scharf	RANDOM
Sertralin	Antidepressivum	HYPER
tödlich	nonfatal	ANT
Gastgeber	Parasit	ANT
Anrichte	Wohnung	PART_OF
Jimmy	neugierig sein	HYPER
Ruhm	Schande	ANT
Cockpit	Rennfahrer	PART_OF
Licht	werfen	RANDOM
Annahme	Ablehnung	ANT
Kapitän	geduldig	RANDOM
Gleichberechtigung	Ungleichheit	ANT
Beschwerde	Beschwerde	HYPER
Bewertung	Beurteilung	HYPER
Vergrößerung	Step-up	HYPER
wählen	Zeitnehmer	PART_OF
Übertreibung	Untertreibung	ANT
Hanf	Galgen	PART_OF
Grabstein	Grabstein	SYN
Katalog	einordnen	HYPER
Trigon	Dreieinigkeit	SYN
Platzregen	waterspout	SYN
Flüssigkeit	Liquidität	SYN
Meile	Liga	PART_OF
Konformist	Nonkonformist	ANT
Schuss	pic	PART_OF
Ankläger	offiziell	HYPER
Aktion	gestalten	RANDOM
aufmerksam	flink	SYN
zuverlässig	unzuverlässig	ANT
Garnierung	ändern	HYPER
Linse	Lehrer	RANDOM
Quecksilber	freundlich	RANDOM
Embolie	Kalender	PART_OF
fluor	Fluorit	SYN
Geschichte	blass	RANDOM
Schlecht	recyceln	RANDOM
Bolzen	Teil	RANDOM
Verschlimmerung	Provokation	SYN
Ellbogen	Tube	HYPER
Idiosynkrasie	Manierismus	SYN
Futter	Transfer	HYPER
Multikulturalismus	Nationalismus	ANT
angeschlossen	angebracht	SYN
Schub	Bewegung	HYPER
Lüge	Weniger	RANDOM
Enchilada	Nahrung	HYPER
bewirken	machen	HYPER
Jakobsmuschel	Jakobsmuschel	PART_OF
verdunkeln	Ohnmacht	SYN
Entschieden	Unentschlossenheit	ANT
Exil	outlander	HYPER
Angemessenheit	Unzulänglichkeit	ANT
Sprint	Postleitzahl	HYPER
cilantro	Koriander	PART_OF
monotheistic	polytheistischen	ANT
Arm	Satz	RANDOM
Revitalisierung	Wiederbelebung	SYN
Kai	Kai	HYPER
tagaktiv	nächtlich	ANT
Beitreten	unangenehm	RANDOM
undurchlässig	durchlässig	ANT
exquisit	daran interessiert	SYN
Keller	Rennen	RANDOM
höhnen	höhnisch	SYN
Porosität	Solidität	ANT
zweideutig	eindeutig	ANT
beobachten	Segeltuch	HYPER
Eishockey	Griff	RANDOM
Kaufen	hoch	RANDOM
Klirren	Zusammenstoß	SYN
wahrscheinlich	unwahrscheinlich	ANT
Daube	Rocker	PART_OF
Schaft	Schuhwerk	PART_OF
Haken	Feder	SYN
Pompano	Pompano	PART_OF
Elternteil	reinigen	RANDOM
oben	Auszahlung	HYPER
Stufe	Gebäude	PART_OF
unerträglich	ziemlich	ANT
männlich	binden	RANDOM
Schnabel	Geist	RANDOM
Generalsrang	Knüppel	HYPER
niedrig	Ideologie	RANDOM
Freude	West-	RANDOM
Bienenstock	Bienenhaus	PART_OF
ebenfalls	Außerdem	SYN
theogony	Domain	HYPER
Spur	Eisenbahn	PART_OF
Deformität	Entstellung	SYN
Hilfe	Box	RANDOM
fähig	unfähig	ANT
Kabine	Kloster	PART_OF
Ball	Weniger	RANDOM
Seltsamkeit	Fremdheit	HYPER
Elektrode	Schaltung	PART_OF
heiß	Lösung	RANDOM
Kick	gewinnen	HYPER
jucken	Infektion	HYPER
Zentner	t	PART_OF
Einreichung	Lager	HYPER
Berechnen	klug	SYN
Unfall	Lehrer	RANDOM
modern	Familie	RANDOM
Periskop	U-Boot	PART_OF
Darm	Torso	PART_OF
Wagen	Drehbank	PART_OF
Bequemlichkeit	Instrumentierung	HYPER
Unbeweglichkeit	Mobilität	ANT
pong	Geruch	HYPER
Anfang	Ursprung	SYN
annektieren	Gebäude	PART_OF
Kätzchen	Wasserfall	RANDOM
springen	Raum	RANDOM
h	Konstante	HYPER
gepflügt	unplowed	ANT
Augenlid	optisch	PART_OF
ti	Strauch	HYPER
Junge	Anfänger	SYN
Nabel	Abdomen	PART_OF
Endivie	Endivie	PART_OF
Mikroprozessor	Mikrocomputer	PART_OF
Neueinstellung	Unterkunft	HYPER
Sacharin	Süßungsmittel	HYPER
zugänglich	unnahbar	ANT
Mangold	Mangold	PART_OF
schwächende	belebend	ANT
jiao	Kwai	PART_OF
zufällig	Glücklicherweise	SYN
Freude	Jahreszeit	RANDOM
einführen	Antlitz	HYPER
Dachdecken	Gebäude	PART_OF
graben	Griff	SYN
Wiederholung	Auftreten	HYPER
Stapel	Haufen	SYN
Tinte	Stoff	RANDOM
Schläfer	Eisenbahn	PART_OF
Landung	Meer	PART_OF
dag	Kilo	PART_OF
wissenschaftlich	unwissenschaftlich	ANT
Spann	Strumpf	PART_OF
Abhilfe	Intervention	PART_OF
Fräulein	Schuh	RANDOM
endokrin	exokrinen	ANT
Vielfalt	Spezies	PART_OF
älteste	relativ	HYPER
Beklagte	Kläger	ANT
konventionell	unkonventionell	ANT
Nanosekunde	Mikrosekunde	PART_OF
Darsteller	Bühne	RANDOM
eats	Nährstoff	HYPER
Armlehne	Automobil	PART_OF
dramatisch	undramatisch	ANT
Kriminalisierung	Entkriminalisierung	ANT
Box	Sonne	RANDOM
Japan	cool	RANDOM
Pracht	Pracht	SYN
Augen	eyeless	ANT
Mensch	Stand	RANDOM
7.	siebte	SYN
Rotor	Obus	PART_OF
Zinke	Schnalle	PART_OF
ändern	Abhilfe	SYN
Technokrat	jemand	HYPER
Tentakel	Auswuchs	HYPER
überfliegen	rutschen	SYN
Zwischendeck	Segeln	PART_OF
Bank	Kader	PART_OF
Nabel	Torso	PART_OF
wohltätig	maleficent	ANT
gezahnt	zahnlos	ANT
Töpfchen	Klo	PART_OF
zurück	bräunen	RANDOM
hüpfen	sinken	RANDOM
beschäftigt	Mitglied	RANDOM
Nation	Wagen	RANDOM
erregbar	reizbar	SYN
Kennzeichen	wild	RANDOM
Uhr	jung	RANDOM
wohlhabend	Zubringer	SYN
Kind	Wort	RANDOM
Firewall	Betätigung	HYPER
Halsband	Polizist	SYN
betroffen	gerührt	SYN
groß	Stein	RANDOM
Behinderung	Untauglichkeit	HYPER
1000	du	SYN
Klasse	Liebhaber	RANDOM
cental	kiloton	PART_OF
Lage	Studio	ANT
Mitte der sechziger Jahre	Alter	PART_OF
mit harten Bandagen	weicher Ball	ANT
neugierig	eigenartig	SYN
heterosexuell	zurück	RANDOM
Klima	Status	HYPER
Angelegenheit	Tatsache	RANDOM
Visa	autorisieren	HYPER
Freispruch	Überzeugung	ANT
Ansporn	Vermittlung	HYPER
himmlisch	engelhaft	SYN
unempfindlich	empfindlich	ANT
Rocker	Wiege	PART_OF
Papier-	hören	RANDOM
Puffer	Lokomotive	PART_OF
zeitliche Koordinierung	Regel	HYPER
Chromosom	Kern	PART_OF
Mord	Stoff	RANDOM
Augmentation	Step-up	HYPER
Repellent	abstoßend	SYN
Schmiede	Ofen	HYPER
Balustrade	Balkon	PART_OF
Außen	gebunden	HYPER
Tinte	prallen	RANDOM
bisher	bisher	SYN
bescheiden	Taschenformat	SYN
Sonnenuntergang	Abend	PART_OF
vermitteln	mittlere	SYN
dl	l	PART_OF
Bahre	Gebäude	PART_OF
unermesslich	messbar	ANT
Block	Motorboot	PART_OF
reiter	Reisende	HYPER
Vierteljahrhundtert	Jahrhundert	PART_OF
Umbettung	Vergraben	HYPER
Retina	optisch	PART_OF
müßig	Vorurteil	RANDOM
Lahar	rutschen	HYPER
unwillkürlich	freiwillig	ANT
Hülsenfrucht	Hülsenfrucht	PART_OF
dramatisieren	verschönern	SYN
Gefährte	Dyade	PART_OF
Flosse	Auto	PART_OF
Korsett	Stiftung	HYPER
Widerspruch	widerstehen	SYN
Haus	halt	RANDOM
Maximierung	Minimierung	ANT
Kanone	Bomber	PART_OF
Metaphase	Meiose	PART_OF
Chip	benutzen	RANDOM
mach weiter	zäh	SYN
Schlecht	Geist	RANDOM
Latte	Gitter	PART_OF
Junior	Senior	ANT
Ärger	provozieren	SYN
Boshaftigkeit	Groll	SYN
breit	breit	SYN
cwt	kiloton	PART_OF
Atmosphäre	Krieg	RANDOM
Sinn	Bedeutung	HYPER
Säugetier	bekommen	RANDOM
Deklination	Ablehnen	SYN
Traber	Schwein	PART_OF
unverschämt	senkrecht	SYN
Aktion	Niveau	RANDOM
Transfer	transponieren	SYN
Okular	Fernglas	PART_OF
lat	dorsum	PART_OF
Glockenblume	Campanula	HYPER
Box	Lauf	RANDOM
Erweiterung	Dateiname	PART_OF
Einstufung	Freigabe	ANT
einträglich	zahlen	SYN
Verfügbarkeit	Unverfügbarkeit	ANT
Hoch	schwacher Anstieg	ANT
Koriander	Koriander	PART_OF
esoterisch	exoteric	ANT
Peitsche	am schlimmsten	SYN
ausrufen	in Worte fassen	HYPER
Hamburger	Hamburger	PART_OF
Feuerstein	verstockt	SYN
abgegrenzt	repräsentiert	SYN
Jeremiade	Einwand	HYPER
Junge	jemand	HYPER
Cannabis	Sex	RANDOM
funktional	nicht funktionsfähig	ANT
Landung	Oase	PART_OF
Heist	Raub	HYPER
beschleunigen	erregen	HYPER
Gitter	Gitter	SYN
Gehirn	Insel	RANDOM
Apfel	Ehefrau	RANDOM
kämpfen	Wettbewerb	SYN
Vorlesung	Kurs	PART_OF
Schlafzimmer	Nummer	RANDOM
Darm	Abdomen	PART_OF
Ärger	ärgern	HYPER
Reparatur	Wiedergutmachung	SYN
glazer	Glaser	SYN
Luftschiff	Flugzeug	HYPER
Deich	lesbisch	HYPER
cytokinesis	verarbeiten	HYPER
Kennzeichen	Halle	RANDOM
tiffin	Ernährung	HYPER
Reif	Dekoration	HYPER
bedeuten	Fehler	RANDOM
verschmelzen	koalesziert	SYN
hilflos	behindert	SYN
Mittelteil	Region	HYPER
Woge	aufblasen	SYN
Murks	Flaum	SYN
Großzügigkeit	Geiz	ANT
Blau	Zug	RANDOM
quantitativ	silbenweise	ANT
Mitverfasser	Autor	HYPER
irrelevant	relevant	ANT
Dame	Ideologie	RANDOM
Hardware-	Software	ANT
wieder einbringen	genesen	SYN
Zustimmung	cool	RANDOM
sperren	Muster	RANDOM
Schädel	caput	PART_OF
konservativ	Liberale	ANT
Helm	Schlepper	PART_OF
Irland	Theater	RANDOM
Ross	Schlachtross	HYPER
heiß	Held	RANDOM
Echo	erinnern	SYN
Bruch	Verletzung	HYPER
aufbauen	Anlagerung	HYPER
Abfuhr	Delikt	HYPER
Echo	nachhallen	SYN
fortsetzen	erhalten	SYN
ängstlich	furchtlos	ANT
Niedergeschlagenheit	Kot	SYN
Lenkung	Segeln	PART_OF
Volk	Vielzahl	SYN
Knauf	Griff	PART_OF
Pflege	Wort	RANDOM
Avocado	Avocado	PART_OF
Karte	Jahreszeit	RANDOM
Bypass	Schaltung	PART_OF
cryptanalysis	Kryptologie	SYN
unersetzlich	austauschbar	ANT
Inspiration	Atmung	PART_OF
Auswahl	salmagundi	HYPER
Meise	Mama	PART_OF
spät	Bisherige	SYN
Angebot	wirbeln	SYN
erleuchtet	unaufgeklärt	ANT
Bewegung	unangenehm	RANDOM
Lunge	Stimmung	RANDOM
Sattel	dorsum	PART_OF
Eintritt	Finsternis	PART_OF
botanischen	botanisch	SYN
avo	pataca	PART_OF
Kommode	Domizil	PART_OF
Freund	trocken	RANDOM
Feuerstein	flinty	SYN
Sitz	Motorboot	PART_OF
Konto	Residenz	RANDOM
getauft	ungetauften	ANT
Scharnier	Auto	PART_OF
Schalldämpfer	Auspuff	PART_OF
cocoanut	Kokospalme	PART_OF
Kochen	zerstören	RANDOM
Sämann	Schöpfer	HYPER
blass	schließen	RANDOM
fadenscheinig	falsch	SYN
China	Kleid	RANDOM
braun	dunkelbraun	SYN
Erkennbare	unbegreiflich	ANT
linear	planar	ANT
Königsdorsch	Makrele	HYPER
Ausbildungsvertrag	Verstehen	HYPER
Mikrogramm	Milligramm	PART_OF
faul	Ausschuss	RANDOM
Oxalacetat	Verbindung	HYPER
Litschi	Litschi	PART_OF
Orange	Residenz	RANDOM
Messe	Foul	ANT
Wunsch	Verlangen	HYPER
paisa	taka	PART_OF
erträglich	unlivable	ANT
effektiv	unwirksam	ANT
Nacht-	dreckig	RANDOM
asper	kurus	PART_OF
Fänger	Befreier	ANT
pochen	zittern	HYPER
Hinweis	Höhle	RANDOM
Grundpfeiler	Aquädukt	PART_OF
Klinge	Mond	RANDOM
unerbittlich	unerbittlich	SYN
hell	Mathematik	RANDOM
Gammler	rotter	SYN
Blinddarm	Blinddarm	PART_OF
intransitiv	transitiv	ANT
gunstock	Handwaffe	PART_OF
Neufassung	abordnen	HYPER
hell	Pack	RANDOM
Klerus	Laien	ANT
Phalanx	Wirbeltier	PART_OF
bewundern	Lärm	RANDOM
obdachlos	Arm	HYPER
machen	Halle	RANDOM
atypisch	typisch	ANT
Antenne	Empfänger	PART_OF
Bezeichnung	finden	HYPER
Dock	Oase	PART_OF
Unsterblichkeit	Mortalität	ANT
Kutikula	Mollusken	PART_OF
Werden	anständig	SYN
Irrelevanz	Relevanz	ANT
engagiert sein	neutral	ANT
Schüssel	Schüsseln	PART_OF
Quietsche	Einheit	HYPER
Jab	stechen	SYN
Auslöschung	Arbeit	PART_OF
Dekret	Befehl	SYN
Internationalismus	Nationalismus	ANT
Acid	virulent	SYN
Land	Recht	RANDOM
Schwiegervater	relativ	HYPER
Verspannung	Rahmen	PART_OF
Butter	der Verkehr	RANDOM
Zwischenspiel	Intermezzo	SYN
Knochen	Bedienung	RANDOM
Loch	der Verkehr	RANDOM
Hubschrauber	Beil	SYN
Wandschrank	Müll	RANDOM
zulässig	unzulässig	ANT
Thane	Edelmann	HYPER
Nachwuchs	Verlassen	RANDOM
Balance	Haltung	SYN
Hilfe	Buchse	RANDOM
derriere	Torso	PART_OF
Booster	Infrastruktur	PART_OF
entehren	Ehre	ANT
Windung	Großhirn	PART_OF
lyrisch	Vokal	PART_OF
Blut	Flucht	RANDOM
Werber	Anbieter	HYPER
kontrolliert	unkontrolliert	ANT
Liebe	Idol	RANDOM
Neigung	lehnen	SYN
genau	ungenau	ANT
intensiv	chronisch	ANT
Dutzende	Tonnen	SYN
unvollkommen	perfekt	ANT
Einlagerungs	Kalender	PART_OF
Angeber	krähen	SYN
Vorliebe	Gefühl	HYPER
Kätzchen	Handel	RANDOM
Kredit	pic	PART_OF
Gottlosigkeit	Frömmigkeit	ANT
glasig	glasartig	SYN
einführen	vermitteln	HYPER
sofort	dalli	SYN
furchtbar	unaussprechlich	SYN
Manschette	Kleidungsstück	PART_OF
nett	Regierung	RANDOM
Verlierer	Gewinner	ANT
anschließen	System	HYPER
lüstern	lüstern	SYN
Nachwuchs	Galaxis	RANDOM
Einrichtung	Bereitschaft	SYN
wissentlich	unwissentlich	ANT
Hymen	Vagina	PART_OF
Sonnenstrahl	Strahl	HYPER
Brust	poulet	PART_OF
Milch	Huf	RANDOM
Demenz	Wahnsinn	HYPER
besorgt	unbekümmert	ANT
Diebstahl	Diebstahl	SYN
Tier	Zehe	RANDOM
Bruder	Schwester	ANT
maxi	Mini	ANT
Schürze	Flugplatz	PART_OF
wasserdicht	Artefakt	HYPER
Aufregung	rühren	SYN
Burleske	imitieren	HYPER
hervorrufen	vorschlagen	SYN
Nanotechnologie	Feld	HYPER
Skrupel	betrachten	HYPER
Flicken	Paket	HYPER
Scheitelkäppchen	Schädel	PART_OF
Darstellerin	Krug	RANDOM
Katzenjammer	Status	HYPER
vergessbar	unvergesslich	ANT
Polster	Schinderei	SYN
unwillkürlich	freiwillig	ANT
Schlag	Satz	RANDOM
grasen	Schicht	HYPER
graubraun	Kitz	SYN
Pfund	cwt	PART_OF
Kapuze	Automobil	PART_OF
Weg	Infrastruktur	PART_OF
pflanzenfress	omnivor	ANT
verdient	unverdient	ANT
männlich	Tor	RANDOM
hinzufügen	Stoff	RANDOM
Rindfleisch	Nachfrage	RANDOM
As	Super	SYN
Penis	heidnisch	RANDOM
degradieren	ernennen	HYPER
Zugänglichkeit	Unzugänglichkeit	ANT
Kamm	Wappen	PART_OF
Palme	manus	PART_OF
gebunden	staccato	ANT
Markt	Spitze	RANDOM
caput	Kreatur	PART_OF
angemessen	unpassend	ANT
mausern	Schuppen	SYN
Geige	ändern	HYPER
Austausch	Transaktion	HYPER
Heiligkeit	Gruppierung	HYPER
drucken	Zugänglichkeit	HYPER
Rechnung	Ende	RANDOM
Borke	heiraten	RANDOM
Schublade	Kommode	PART_OF
Tenor	Musiker	HYPER
Meter	Damm	PART_OF
Obst- und Gemüsehändler	Händler	HYPER
konzentriert	unkoordiniert	ANT
Ungeduld	die Geduld	ANT
Schaft	Schubkarre	PART_OF
tapper	jemand	HYPER
Schüssel	gehen	HYPER
verleihen	ändern	HYPER
Töpfchen	kann	PART_OF
Kinn	Homo	PART_OF
farbig	einseitig	SYN
homogene	homogene	SYN
Badewanne	Wohnung	PART_OF
Marktplatz	Auslauf	HYPER
Altphilologe	romanticist	ANT
Blatt	Lösung	RANDOM
Darm	Torso	PART_OF
flehend	Imperativ	ANT
Deziliter	l	PART_OF
furchtbar	erschreckend	SYN
Weg	Transit	PART_OF
gesamt	ändern	HYPER
Jack	Jackfrüchte	PART_OF
adressierte	nicht adressiert	ANT
blaues Halsband	white-collar	ANT
Gurt	Straps	PART_OF
e	Graphem	HYPER
Kanonenboot	Wasserfahrzeug	HYPER
Damm	Hügel	HYPER
heilen	Intervention	PART_OF
Amateur	Athlet	HYPER
befürworten	predigen	SYN
Nachrichten	Empfangshalle	RANDOM
trigon	trilateralen	SYN
Ringel	Frisur	PART_OF
Berg	Party	RANDOM
Kraftwerk	Infrastruktur	PART_OF
Turbostrahltriebwerk	Turbostrahltriebwerk	PART_OF
Jab	Geste	HYPER
Linie	Integrität	RANDOM
Balance	Unausgewogenheit	ANT
Nektarine	Nektarine	PART_OF
Ehe	Anzahl	RANDOM
lose	Asien	RANDOM
Butter	Dame	RANDOM
auf halbem Weg	Karneval	PART_OF
Wechselbalg	Kretin	SYN
Krebs	Leicht	RANDOM
erhalten	wahrnehmen	HYPER
Athlet	aufladen	RANDOM
Primel	Primel	SYN
Vorliebe	Vermögenswert	HYPER
zahlungsunfähig	Lösungsmittel	ANT
Kugelfisch	puffer	PART_OF
verschlingen	steil	SYN
Blumenkrone	blühen	PART_OF
Hals	Artefakt	HYPER
Handwerker	Handwerker	SYN
sechzehnte	Position	HYPER
Unterkunft	Artefakt	HYPER
Hypnose	Bedingung	HYPER
unveräußerlich	unalienable	SYN
Deserteur	quitter	HYPER
machen	Flug	RANDOM
Oregano	Majoran	PART_OF
Inserat	assoziieren	HYPER
heruntergekommen	erbärmlich	SYN
Kapitel	Fertig	RANDOM
Kapazität	Unfähigkeit	ANT
haften	aufhängen	SYN
Effet	Trend	SYN
bestätigen	eingestehen	SYN
Haken	Schlinge	SYN
pel	Raster	PART_OF
Prost	von oben nach unten	ANT
Zylinder	Kompressor	PART_OF
günstig	unglücklich	ANT
wahnsinnig	gestört	SYN
Piss	urinieren	SYN
Sweatshirt	schwitzt	PART_OF
Briefumschlag	Ballon	PART_OF
Wörter	Dialog	PART_OF
Portion	Verdienste	PART_OF
Innenfeld	Außenfeld	ANT
Sperma	ejakulieren	PART_OF
Nation	schmutzig	RANDOM
Kette	Zutat	RANDOM
Stoßen	Sporn	SYN
ansprechbar	unempfänglich	ANT
Furz	furzen	SYN
dritte	Automobil	PART_OF
Ruhe	Fisch	RANDOM
Kern	Bibliothek	RANDOM
mitteilbar	tragbare	SYN
Monster-	Anomalie	HYPER
Ölfeld	Feld	HYPER
Konto	Maschine	RANDOM
Barsch	Meile	PART_OF
unwillig	bereit	ANT
Radius	Arm	PART_OF
Nachahmung	Nachahmung	SYN
Kapitel	Regel	RANDOM
Absurdität	Merkmal	HYPER
verfassungsmäßig	verfassungswidrig	ANT
schmalzen	äußern	HYPER
Kriminalisierung	Entkriminalisierung	ANT
Fontanelle	geringer	PART_OF
Fang	machen	RANDOM
Killer	Torpedo	SYN
Stiftung	Struktur	PART_OF
konzentrisch	Exzenter	ANT
Aussehen	Verschwinden	ANT
versenken	rutschen	SYN
peinlich	beunruhigend	SYN
Schnitzer	Schnitzer	SYN
vermuten	vorstellen	HYPER
Abstumpfung	ermüdend	SYN
Verknüpfung	Scheibe	RANDOM
Objekt	Schaffung	RANDOM
Beruf	Bekenntnis	HYPER
Wissen	Geld	RANDOM
Mensch	produzieren	RANDOM
Homosexuelle	loben	RANDOM
Rand	Zauberstab	SYN
Kollektivismus	Orientierung	HYPER
deaktivieren	Aktivieren	ANT
Nadir	Firmament	PART_OF
Fotomontage	ikon	HYPER
Geländer	Geländer	PART_OF
Fontanelle	Nestling	PART_OF
Belag	Mahl	PART_OF
Kardamom	Kardamom	PART_OF
bombardieren	klopfen	HYPER
Kapuze	Auto	PART_OF
egoistisch	selbstlos	ANT
Mississippi	Kampf	RANDOM
düster	trostlos	SYN
Docht	Kerze	PART_OF
Krankheit	richtig	RANDOM
gonzo	überspannt	SYN
Stärke	stehlen	PART_OF
vordatieren	aufnehmen	HYPER
breit	eng	ANT
Kiefer	o	HYPER
Talent	Eignung	HYPER
Chlorat	Salz-	HYPER
Femur	Schenkel	PART_OF
Alba	Robe	HYPER
Aufmerksamkeit	Unaufmerksamkeit	ANT
weit verbreitet	weit verbreitet	SYN
mutwillig	Romantik	HYPER
Unvorsichtigkeit	Klugheit	ANT
Schlechtigkeit	Güte	ANT
Anwendung	Aktivität	HYPER
laut	Mantel	RANDOM
Apotheose	Nonesuch	SYN
Ehe	Kunst	RANDOM
Taille	Schlägerkopf	PART_OF
Kohlenarbeiter	Arbeiter	HYPER
glaubwürdig	unglaublich	ANT
hell	Scheren	RANDOM
Schläfrigkeit	Wachsamkeit	ANT
Klasse	missverstehen	RANDOM
Anulus	Rock	SYN
Borte	Teppich	PART_OF
midterm	Schwangerschaft	PART_OF
mischen	Energie	RANDOM
Sprosse	Gebäude	PART_OF
Moderator	Helfer	HYPER
Phalanx	Daktylus	PART_OF
Liste	Beziehung	HYPER
stören	beeinflussen	HYPER
Gladiole	Brustbein	PART_OF
Hundehütte	Nebengebäude	HYPER
verfolgen	Nessel	HYPER
Angebot	Lohn	HYPER
Mismatch	äquivalent	HYPER
Sortiment	Einstufung	SYN
distale	proximal	ANT
Vorfahr	Nachkomme	ANT
Begünstigter	Empfänger	HYPER
Kette	Seite	RANDOM
Anticholinergikum	cholinergen	ANT
Sonnenuntergang	Abendzeit	PART_OF
Lager	Schutz	HYPER
Erbse	Gemüse	HYPER
Okular	Sehenswürdigkeiten	PART_OF
Papier-	Loch	RANDOM
Teenager	teenaged	SYN
Explosion	Ausdruck	HYPER
Original-	wörtlich	SYN
gebunden	ungebundene	ANT
Nein	Ja	ANT
Träger	Sargträger	SYN
Übergang	Änderung	HYPER
Maschine	Horn	RANDOM
zimperlich	gekünstelt	SYN
Diktion	Formulierung	SYN
Angemessenheit	Unangemessenheit	ANT
prellen	verwöhnen	SYN
Welle	Gebäude	PART_OF
Tadel	verdienen	ANT
Stampfen	pochen	SYN
Anzündholz	Beleuchtung	SYN
Entlassung	Sack	SYN
Rachen	Hals	PART_OF
Meilenstein	Auftreten	HYPER
Damebrett	Entwürfe	PART_OF
Sektor	Feld	PART_OF
Wichtigtuer	meddler	HYPER
Tänzer	Sein	HYPER
Penis	Topf	RANDOM
minimieren	untertreiben	SYN
Schulterblatt	Schulter	PART_OF
Kapitän	nass	RANDOM
Gitter	Ofen	PART_OF
ersticken	Rauch	HYPER
sternenlos	sternenklar	ANT
Hoden	Hoden	SYN
Kamerad	Instrument	RANDOM
Handlung	Fahrzeug	RANDOM
Baseball	Kopf	RANDOM
Funken	jotting	SYN
hoch	Null	RANDOM
gepflastert	ungepflastert	ANT
Basic	einleitend	SYN
adaptiv	maladaptiven	ANT
Instabilität	Stabilität	ANT
Verbot	verbannen	SYN
Schnittlauch	Schnittlauch	PART_OF
relishing	Aufnahme	HYPER
Prognose	Aussicht	SYN
nett	Lied	RANDOM
Basketball	Haustier	RANDOM
kühn	unerschrocken	SYN
Buffet	Ernährung	HYPER
liebenswert	liebenswürdigen	SYN
Ablenkung	Amüsement	HYPER
Bourgeois	Bürger	SYN
Blau	etwas	RANDOM
Absendung	Expedition	SYN
ebenso	wiederholen	HYPER
beschwichtigen	bleibe	SYN
wünschenswert	unerwünscht	ANT
Gleichberechtigung	Ungleichheit	ANT
Absatz	Veröffentlichung	PART_OF
Exon	Intron	ANT
auslösen	Vermittlung	HYPER
Einberufung	Enteignung	PART_OF
Augenlid	oculus	PART_OF
schmierigen	erbärmlich	SYN
monotone	eintönig	SYN
Schaufel	Hubschrauber	PART_OF
Rechnung	voll	RANDOM
Werden	schicklich	SYN
Kommen	zeitliche Koordinierung	HYPER
belüftete	berechnet	SYN
niedriger	Kommunikation	RANDOM
Sektion	Zug	PART_OF
Anfang	Ende	ANT
dehydriert	getrocknet	SYN
Gutschein	Bewunderer	HYPER
Turbofan	Jet	HYPER
Baumstamm	Pigment	HYPER
Griff	Aufkleber	PART_OF
Dirham	Dinar	PART_OF
Kamerad	Hut	RANDOM
Netz	Gebärmutter	PART_OF
verlieren	Bauernhof	RANDOM
Partisan	Booster	HYPER
Knechtschaft	Leibeigene	HYPER
Marabu	marabout	PART_OF
freudlos	freudig	ANT
Liebe	Individuell	RANDOM
metallisch	nichtmetallischer	ANT
Ventil	Messing-	PART_OF
abnehmend	Waxing	ANT
Sog	Strom	HYPER
Rollbahn	Transit	PART_OF
Kanone	Vierfüßler	PART_OF
gesprächig	geschwätzig	SYN
Weg	Einheit	HYPER
Einkerbung	Angebot	PART_OF
Balance	Tatsache	RANDOM
positiv	Negativ	ANT
weitläufig	strähnig	SYN
Wahrscheinlichkeit	Unwahrscheinlichkeit	ANT
Flugzeug	Theorie	RANDOM
energetisieren	anregen	SYN
Schober	Kumulus	HYPER
Dringlichkeit	Prise	SYN
Thron	Klo	PART_OF
Bogen	unangenehm	RANDOM
Helligkeit	Dumpfheit	ANT
entschieden	zweifellos	SYN
Rappen	Dinar	PART_OF
wenig	Nachfrage	RANDOM
meditativ	nachdenklich	SYN
Bett	Axt	RANDOM
Abdomen	Bauch	PART_OF
Interferenz	Noninterference	ANT
Charme	Geschmack	HYPER
erwähnen	Referenz	SYN
Wandschrank	lehren	RANDOM
schwarz	Tag	RANDOM
Einwohner	Sein	HYPER
hat verloren	gewonnen	ANT
groß	Kofferraum	RANDOM
Pumphose	Schlüpfer	SYN
rechtmäßig	rechtmäßig	SYN
Mäßigung	Mäßigkeit	SYN
verlieren	verbreitet	RANDOM
Griffbrett	Banjo	PART_OF
Häutung	Mauser	SYN
Kunst	gehen	RANDOM
inokulieren	ändern	HYPER
Cutter	Zubringer	HYPER
ausführen	erschlagen	HYPER
Bart	Schnurrhaare	SYN
mesic	xeric	ANT
braten	Nestling	SYN
Quecksilber	Schüler	RANDOM
nettlesome	ärgerlich	SYN
bucklig	bucklig	SYN
Kette	Ehe	RANDOM
Wasserweg	Artefakt	HYPER
falten	Gehege	HYPER
Rückgewinnung	Reformation	SYN
Staubblatt	Angiospermen	PART_OF
Küsten	Off-Shore	ANT
Einbaum	Baseballstadion	PART_OF
Chiffre	Null	SYN
Atomkraftwerk	angreifen	HYPER
Wanne	Wohnen	PART_OF
schön	Aufzeichnung	RANDOM
sterbend	Lebenszeit	PART_OF
Sprache	Dichtung	RANDOM
Zielsetzung	subjektiv	ANT
Remission	Buße	PART_OF
zweihäusig	monoecious	ANT
Respektlosigkeit	Ehrfurcht	ANT
Schaltier	Mollusken	PART_OF
Zufriedenheit	Unzufriedenheit	ANT
Demut	beschäftigt	RANDOM
Ignoranz	Rahmen	RANDOM
theogony	Feld	HYPER
Einmischung	übereifrig	SYN
Empfangshalle	nehmen	RANDOM
Geheimhaltung	Merkmal	HYPER
Flexibilität	Inflexibilität	ANT
Vorsatz	Bereitstellung	HYPER
hoffnungsvoll	hoffnungslos	ANT
unhöflich	höflich	ANT
mich	Lärm	RANDOM
Besicherung	unfundiert	ANT
Klappentext	Billigung	SYN
Junge	Ozean	RANDOM
Ehe	ankommen	RANDOM
Handlung	Schnee	RANDOM
wankelmütig	Quecksilber	SYN
Ansporn	harry	HYPER
Porosität	Solidität	ANT
niedergeschlagen	begeistert	ANT
Vorbereitung	Auflösung	ANT
Sakristei	Kirche	PART_OF
Locator	Landvermesser	HYPER
endlich	unendlich	ANT
Einführung	Konzert	PART_OF
Liter	hl	PART_OF
Karambolage	Billard	PART_OF
Erwachsene	Nacht-	RANDOM
Springflut	Tide	PART_OF
angefochtenen	unbestritten	ANT
Flosse	Automobil	PART_OF
Flusskrebs	Flusskrebs	PART_OF
Geburtswehen	Schwangerschaft	PART_OF
Treiber	Programm	HYPER
Kanal	aktiv	RANDOM
unmäßig	mäßig	ANT
Cliff	Drop-off	SYN
klebrig	pastösen	SYN
Stammbaum	Abstammung	SYN
Quecksilber	haben	RANDOM
ausschelten	Tadel	SYN
umkehren	Klasse	HYPER
verbessert	unbebaut	ANT
Kontur	umreißen	HYPER
Motiv	Thema	SYN
heilig	unheilig	ANT
Film	Wörterbuch	RANDOM
schnöde	stolz	SYN
Schiedsrichter	Behörde	HYPER
Gitter	Angebot	PART_OF
Behinderung	obstruktiv	SYN
Aufnahme	Atmung	PART_OF
Blinddarm	Blinddarm	SYN
gesetzlos	verbieten	SYN
Kabeljau	Schote	SYN
Corona	Nimbus	PART_OF
frohlocken	Schadenfreude	SYN
montieren	stark	RANDOM
Nadir	Himmel	PART_OF
Wachtel	Wachtel	PART_OF
Rasieren	Aufräumen	HYPER
jugular	Gebärmutterhals	PART_OF
Dysphorie	Unzufriedenheit	HYPER
pinger	U-Boot	PART_OF
Herzmuschel	Rüsche	SYN
Fall	Scheitern	RANDOM
Luft	bräunen	RANDOM
Start	richtig	RANDOM
Zwielicht	Einbruch der Dunkelheit	SYN
Klammer	Sortieren	HYPER
Tarsus	Wirbeltier	PART_OF
Ozean	schließen	RANDOM
Klaue	kämpfen	PART_OF
Lüge	sinken	RANDOM
Rheuma	Krankheit	HYPER
schnell	Wasserweg	HYPER
Existenz	Nicht-Existenz	ANT
Eis	Strafverfolgung	RANDOM
lustig	leidlich	SYN
Parterre	Theater	PART_OF
vorausgehen	Prämisse	SYN
Kirsche	Kirsche	PART_OF
kräuseln	Biege	SYN
Linie	Fenster	RANDOM
Bullauge	Flugzeug	PART_OF
reacquaint	vertraut machen	HYPER
angegriffen	gestressten	SYN
Herzschlag	Auftreten	HYPER
Kanal	Infrastruktur	PART_OF
Versagen	durchfallen	SYN
unterdrücken	unterwerfen	HYPER
Luft	Belohnung	RANDOM
Bildbeschriftung	Film	PART_OF
Bit	Bleistift	RANDOM
Jujube	Jujube	PART_OF
reinigen	Kamin	RANDOM
Schrein	umgeben	HYPER
Fixer	Verbindung	HYPER
Modell-	simulieren	HYPER
unzufrieden	zufrieden	ANT
Landschaftsbau	Gartenarbeit	HYPER
Ketchup	Würze	HYPER
akklimatisieren	akklimatisieren	SYN
begehrlich	Greif-	SYN
Halfter	Galgen	PART_OF
wild	verrückt	SYN
Kanal	Truthahn	RANDOM
reinigen	Sublimat	SYN
Arithmetik	Recht	RANDOM
Luftangriff	Attacke	HYPER
Barbar	unzivilisiert	SYN
Anhänger	Schüler	SYN
schön	perfekt	RANDOM
hell	Wohnung	RANDOM
schmerzlich	schmerzlos	ANT
reizen	Nessel	SYN
kriechen	Schlaganfall	HYPER
zweipolig	unipolar	ANT
unmerklich	wahrnehmbar	ANT
Eis	Entspannen Sie Sich	RANDOM
Förder	Fabrik	PART_OF
dick	dünn	ANT
Mund	nehmen	RANDOM
Zorn	Tastatur	RANDOM
Choke	dämpfen	HYPER
Badewanne	Aufenthalt	PART_OF
foreleg	Vierfüßler	PART_OF
Kinderarzt	medico	HYPER
Schokolade	Hammer	RANDOM
bekleideten	unbekleidet	ANT
Festzelt	Überdachung	HYPER
Vorteil	Tempel	RANDOM
Vorbereitung	Auflösung	ANT
Ausströmen	Zustrom	ANT
Kadenz	Meter	SYN
Wankelmut	Untreue	HYPER
Mitglied	Regenschirm	RANDOM
verweisen	assoziieren	HYPER
montieren	blass	RANDOM
Kette	pflücken	RANDOM
Liter	dal	PART_OF
Verwerfung	Beeinträchtigung	HYPER
Junge	führen	RANDOM
Illusion	Trick	SYN
Parkett	Theater	PART_OF
Ehre	betrachten	HYPER
Dystopie	Utopie	ANT
Hostess	Patron	HYPER
penstock	Regler	HYPER
anspruchslos	gehobene	ANT
sterbend	Lebenszeit	PART_OF
Nabel-	Embryo	PART_OF
Butter	Qualität	RANDOM
höchste	überwiegend	SYN
mezzo	Mezzosopran	SYN
niedergeschlagen	grimmig	SYN
Verstauchung	Trauma	HYPER
schwarz	Weiß	ANT
Aufwertung	Einstufung	HYPER
Tinte	Ufer	RANDOM
mercer	Händler	HYPER
antiphonal	ansprechbar	SYN
Deckel	ganze	RANDOM
Zeitraum	Äon	PART_OF
niedriger	Recht	RANDOM
umrüsten	liefern	HYPER
articled	indentured	SYN
Produkt	Auslauf	PART_OF
machen	kurz	RANDOM
Abriss	Zerstörung	SYN
Ausbildung	Aktivität	HYPER
Kult	Mode	SYN
degradierte	aufrührerisch	SYN
auffällig	laut	SYN
zurück	hoch	RANDOM
Jubel	schreien	SYN
Mitte der achtziger Jahre	eld	PART_OF
Pro-Choice	für's Leben	ANT
Irland	schreiben	RANDOM
porter	Beefsteak	HYPER
Kommode	Klo	PART_OF
Schreibstube	Kloster	PART_OF
unwiderruflich	widerruflich	ANT
Haft	Schwangerschaft	PART_OF
bürgerlich	unhöflich	ANT
Burleske	Pamphlet	SYN
Spinat	Spinat	PART_OF
sauer	alkalisch	ANT
Verstand	Mais	RANDOM
Acid	Verbindung	HYPER
sich spezialisieren	variieren	HYPER
Inspiration	Belüftung	PART_OF
herder	Hirt	SYN
Offizier	Seemann	HYPER
aufsteigen	verstehen	RANDOM
Fleck	Streifen	SYN
Bogen	Aquädukt	PART_OF
Angelegenheit	Kofferraum	RANDOM
Bogen	Arkade	PART_OF
freundschaftlich	feindlich	ANT
aufgeräumt	unordentlich	ANT
Sexismus	Bevorzugung	HYPER
bekloppt	verrückt	SYN
mil	cl	PART_OF
Antiseptikum	septisch	ANT
geplant	ungeplant	ANT
bemerkte	unbemerkt	ANT
Dummkopf	Dummkopf	SYN
Leiste	Deich	SYN
seetüchtig	seeuntüchtig	ANT
normal	paranormal	ANT
Ausfallzeit	Betriebszeit	ANT
Foul	abstoßend	SYN
unermesslich	unschätzbar	SYN
fröhlich	Tracht Prügel	SYN
Fluchen	Substanz	HYPER
Gefühllosigkeit	Empfindlichkeit	ANT
identifizierbar	nicht identifizierbar	ANT
Apfelsoße	Proviant	HYPER
Kiel	Rumpf	PART_OF
Delikatesse	Urteilsvermögen	HYPER
Konus	Kerze	PART_OF
Dope	Info	HYPER
dextral	sinistral	ANT
konform	trotzig	ANT
springen	Natur	RANDOM
neu	energetisieren	HYPER
Spanne	Infrastruktur	PART_OF
gebrechlich	robust	ANT
handhabbar	unhandlich	ANT
schwarz	Weiß	ANT
Leere	Fülle	ANT
Schlafgemach	Domizil	PART_OF
hervorrufen	Extrakt	SYN
Bengel	tyke	HYPER
Index	quetschen	RANDOM
Spur	vermuten	SYN
Karte	Ernte	RANDOM
pränatal	pränatal	SYN
Entsalzung	Entsalzung	SYN
Veilchen	Prellung	HYPER
kernlos	schäbig	ANT
Kompatibilität	Unvereinbarkeit	ANT
Schritt	Schritt	SYN
Paging	Äußerung	HYPER
Luftröhre	Hals	PART_OF
Eisen	Feindseligkeit	RANDOM
Bettler	Bettler	SYN
Surfen	gehen	HYPER
adit	Zeche	PART_OF
Einzel	Tennis	HYPER
verstopfen	Foul	SYN
Rechnung	Hose	RANDOM
Spitze	Zug	RANDOM
Missbrauch	vilification	SYN
Nabel	Bauch	PART_OF
Aufnahme	Atmung	PART_OF
Paintball	Kapsel	HYPER
kollek	staatlich kontrollierte	SYN
Stumpf	verwirren	HYPER
Zustimmung	Statue	RANDOM
Beginn	Anfang	SYN
gerührt	unbewegt	ANT
erzwungen	unenforced	ANT
Kurkuma	Kurkuma	PART_OF
Kruppe	Vierfüßler	PART_OF
Salon	Wohnen	PART_OF
Ruhe	nutzlos	RANDOM
korrigiert	unkorrigiert	ANT
gelistet	nicht aufgeführt	ANT
Fragesteller	Redner	HYPER
männlich	Joint	RANDOM
instrumental	Vokal	ANT
bemerkbar	unnoticeable	ANT
Spann	pes	PART_OF
hinter	Gebäck	SYN
Tormann	Torwart	SYN
lose	müßig	RANDOM
auffallend	unscheinbar	ANT
Pint	Quart	PART_OF
Hauseigentümer	Haushaltsvorstand	SYN
überzeugend	wenig überzeugend	ANT
Gefährte	twain	PART_OF
Atmosphäre	Ehe	RANDOM
Ausströmen	Zustrom	ANT
Venturi	Vergaser	PART_OF
Entmutigung	Förderung	ANT
Bild	Fazit	RANDOM
Not	Strenge	SYN
Prozessor	Besorgnis	HYPER
verdrahtet	kabellos	ANT
immer	für immer	SYN
Abwehr	Ablehnung	HYPER
Naivität	Eleganz	ANT
Lachs	Lachs	PART_OF
Exsudat	ausscheiden	HYPER
mit harten Bandagen	weicher Ball	ANT
schleimig	unwürdig	SYN
Sprache	Gegenstand	RANDOM
Nichtverbreitung von Atomwaffen	Proliferation	ANT
Hilfe	Würfel	RANDOM
Latte	Holz	HYPER
konkav	konvex	ANT
Musik-	alt	RANDOM
hoch	Auto	PART_OF
Hardware-	Software	ANT
Luft-zu-Oberfläche	Boden-Luft	ANT
Mauerwerk	Gebäude	PART_OF
Haus	Gummi	RANDOM
Magnolie	Magnolie	PART_OF
eukaryotische	prokaryotische	ANT
Kreuzfahrt	Reise	HYPER
Woche	Arbeitswoche	SYN
getrimmt	untrimmed	ANT
analog	Digital	ANT
Schmerzen	Regen	RANDOM
elegant	anmutig	SYN
Eis	Log	RANDOM
Jacke	Landschaft	RANDOM
voraussagen	bedeuten	SYN
entweihen	heilig	ANT
Impetus	Impuls	SYN
immatrikulieren	registrieren	HYPER
Empfangshalle	anfügen	RANDOM
anal	Oral	ANT
Zwei	Dickens	SYN
Keller	Stumpf	RANDOM
Frieden	Kristall	RANDOM
schemenhaft	vage	SYN
Dysphorie	Euphorie	ANT
Unfall	Held	RANDOM
mulmig	unruhig	SYN
Chor	Vokal	PART_OF
betrügen	prallen	RANDOM
beladen	entladen	ANT
Schönheit	Hut	RANDOM
Mikron	Zentimeter	PART_OF
Grab	sculpt	SYN
Rauchfang	Passage	HYPER
Potpourri	Vielfalt	SYN
Teil	Durchgang	RANDOM
Leck	Reise	RANDOM
dm	Meter	PART_OF
schwarz	Küche	RANDOM
angeboren	natürlich	SYN
eingehend	abgehend	ANT
abrufen	holen	HYPER
Scheitelkäppchen	braincase	PART_OF
Krippe	Cribbage	PART_OF
Schall-	Überschall-	ANT
staffeln	stellen	HYPER
Decke	sich ausruhen	RANDOM
Glied	Portion	HYPER
schändlich	beschämend	SYN
Süßigkeiten	Zehe	RANDOM
natürlich	unnatürlich	ANT
schwimmfähig	Wasser-	ANT
aussprechen	singen	SYN
Phosphat	Getränk	HYPER
konventionell	nuklear	ANT
Tier	Aggressor	HYPER
Faktor	Chromosom	PART_OF
brauchbar	unbrauchbar	ANT
Zentimeter	dm	PART_OF
Herstellung	Wolf	RANDOM
verlassen	sich weigern	RANDOM
80	achtzig	SYN
Nachrichtenredaktion	Büro	HYPER
Hierarchie	Verwaltung	PART_OF
würdevoll	unwürdig	ANT
Singvogel	Sänger	SYN
taoiseach	Premier	HYPER
Gipfel	Pfeil	PART_OF
Wiedergutmachung	Erlösung	HYPER
Chaos	reichlich	SYN
beschäftigt	arbeitslos	ANT
Hypothalamus	forebrain	PART_OF
Glauben	haben	RANDOM
Mitte	Socke	RANDOM
Zucht	Gebäude	PART_OF
Fontanelle	Rasierapparat	PART_OF
Leerlauf	Tat	HYPER
Bit	Wolkenkratzer	RANDOM
Gürtel	Schärpe	SYN
Festnahme	Halsband	SYN
angeknackst	Hemd	PART_OF
Schnecke	Patrone	PART_OF
geklebt	geklebt	SYN
vorrücken	Gedicht	RANDOM
Treiber	Hirt	SYN
Frosch	Ornamentik	HYPER
Konto	freundlich	RANDOM
Medizin	Fertig	RANDOM
mcg	mg	PART_OF
Buch	Selten	RANDOM
Morgen	Freude	RANDOM
Elend	Fröhlich	RANDOM
Leibwächter	Gefolge	PART_OF
mickrig	armselig	SYN
Gummierung	Kauen	HYPER
verblüffen	verwirren	SYN
rekonstruiert	unreconstructed	ANT
Bequemlichkeit	Unbequemlichkeit	ANT
Gurt	Klammer	PART_OF
schlagen	Fix	RANDOM
Kichererbse	Kichererbse	PART_OF
Grabstein	Grab	PART_OF
mischen	Kind	RANDOM
verschwenderisch	verschwenderisch	SYN
archäologisch	archäologisch	SYN
Hohlheit	Solidität	ANT
zustimmen	verschieben	SYN
änderbar	unveränderlich	ANT
Aufhänger	jemand	HYPER
goodly	ansehnlich	SYN
Blinder	Blinker	SYN
Kanal	Struktur	HYPER
kriminalisieren	kriminalisieren	SYN
Hinterteil	keister	SYN
Aktivierung	Deaktivierung	ANT
grob	fein	ANT
beschriften	versprechen	HYPER
Asymmetrie	Symmetrie	ANT
Karibu	Rentier	SYN
Deponien	mopes	SYN
Adjektiv	Adjektiv	PART_OF
Index	Überschrift	ANT
Innenfeld	Außenfeld	ANT
Maurer	Geselle	HYPER
unten	nach oben	ANT
Notwendig	unnötigerweise	ANT
Passanten	Ursache	HYPER
Lieferung	gebärfähigen	PART_OF
zahlen	angestellten-	SYN
zu Verfügung stellen	Transfer	HYPER
barfuß	shoeless	SYN
Windschutzscheibe	Motorboot	PART_OF
debar	vermeiden	SYN
versteckt	offen	ANT
Drachenköpfe	Drachenköpfe	PART_OF
integrieren	Zahl	HYPER
altruistisch	selbstsüchtig	ANT
ausrichten	Stichelei	HYPER
Patrone	Grammophon	PART_OF
Gebot	ethisch	PART_OF
strukturiert	unstrukturierten	ANT
Zweikammer-	Einkammer-	ANT
Biege	Park	RANDOM
Brieftasche	Geldbörse	SYN
wenigste	die meisten	ANT
Cappuccino	Java	HYPER
rückwärtig	nach rückwärts	SYN
greenbelt	Greenway	SYN
Schneebesen	Rührgerät	HYPER
Heilung	Plastination	PART_OF
Monitor	Album	RANDOM
unwirksam	operativ	ANT
innere	nach außen	ANT
Schäumen	schaumig	SYN
unterbringen	passen	SYN
medizinisch	chirurgisch	ANT
kreisförmig	runden	SYN
Schnorchel	Unter	PART_OF
verkeilt	Keyless	ANT
synapsid	Reptilien-	HYPER
Gelatine	Ernährung	HYPER
Ruhe	Anordnung	HYPER
Schnupftabak	Kerzendocht	PART_OF
Vorteil	besser	HYPER
Soja	Soja	PART_OF
Angebot	Umfang	SYN
wahnsinnig	geistig gesund	ANT
Herzenskummer	Herzeleid	SYN
Aufstieg	Abstammung	ANT
Soße	Mahl	PART_OF
Sack	perforieren	HYPER
Baseball	Molekül	RANDOM
übergreifen	verletzen	SYN
Gummierung	Gemurmel	SYN
schmackhaft	toothsome	SYN
Gusseisen	Eisen	SYN
Tomatillo	Tomatillo	PART_OF
Nichtzahlung	Handelsgeist	HYPER
sura	Schaft	PART_OF
nada	Null	SYN
Gör	Schlingel	HYPER
Penetration	Verkehr	HYPER
Box	langsam	RANDOM
Stummel	Ding	HYPER
Maske	Artefakt	HYPER
Leckerbissen	behandeln	HYPER
Klammer	Gesundheit	RANDOM
hupen	Kotzen	SYN
tragen	Wind	RANDOM
Erg	Einheit	HYPER
schlagen	Zustand	RANDOM
Schreck	Schrecken	SYN
Altruismus	Egoismus	ANT
Pfeffer	Würze	HYPER
kompatibel	unvereinbar	ANT
Instabilität	Stabilität	ANT
Koda	Opus	PART_OF
Vitamin	Nährstoff	HYPER
Reiten	die Leichtathletik	HYPER
Riss	Spalt	SYN
Bolzen	Sie	RANDOM
Mord	Kontinent	RANDOM
Karat	Gramm	PART_OF
Beobachter	Sein	HYPER
Schiene	anprangern	HYPER
entlarven	Tücke	SYN
Rat	diskutieren	HYPER
Antworten	Schaf	RANDOM
Gefühllosigkeit	Empfindlichkeit	ANT
jugendlich	jemand	HYPER
Sack	Stoßen	SYN
Kanal	gleich	RANDOM
Stuhl	Mitglied	RANDOM
Luke	versenken	PART_OF
Dock	Meer	PART_OF
Eisen	Unglück	RANDOM
differenzierte	undifferenziert	ANT
Mikron	Millimeter	PART_OF
Aggregat	Gesamtheit	SYN
bewundern	fest	RANDOM
Ringel	Frisur	PART_OF
brewpub	Werk	HYPER
hintere	Torso	PART_OF
sparen	Eingemachtes	SYN
artikulieren	unartikuliert	ANT
Milch	Stadt	RANDOM
Balance	Schuh	RANDOM
Anstrengung	Verdrehung	SYN
bestehen	Gesundheit	RANDOM
Daemon	Teufel	SYN
sicher	unsicher	ANT
Regal	Bücherregal	PART_OF
Erinnerung	Plattform	PART_OF
Störung	verärgert	HYPER
feminin	kastrieren	ANT
Importeur	Kapitalist	HYPER
schädlich	harmlos	ANT
Kanone	Karambolage	SYN
26	sechsundzwanzig	SYN
Thesaurus	Referenz	HYPER
Spott	Taten	HYPER
Antwort	Modus	HYPER
Gramm	hg	PART_OF
Gesetzgebung	Führung	HYPER
Schärfe	Intelligenz	HYPER
Strenge	Temperament	HYPER
Lage	Studio	ANT
Kamerad	Log	RANDOM
Enge	Breite	HYPER
Bescheidenheit	Reservieren	SYN
Herstellung	verunsichern	RANDOM
Sicherheit	indirekt	SYN
Ungleichgewichts	Gleichgewicht	ANT
Gemeinsamkeit	Individualität	ANT
Kochen	Minute	RANDOM
synchronisieren	ordnen	HYPER
Abstammung	Blut	SYN
Graben	Schanze	PART_OF
Formel	Botschaft	HYPER
Millimeter	cm	PART_OF
Bogen	Handlung	RANDOM
Behälter	sogar	RANDOM
Reversion	Kehrtwendung	SYN
berauschend	leichtsinnig	SYN
leidenschaftlich	leidenschaftslos	ANT
Gemälde	Gebäude	PART_OF
heterosexuell	heftig	RANDOM
Verlaufen	Rudern	PART_OF
costa	Wirbeltier	PART_OF
Haus	Radio	RANDOM
verlassen	Obst	RANDOM
bekloppt	Cracker	SYN
Sättigung	Lebendigkeit	SYN
Veröffentlichung	Verlagswesen	SYN
unklug	umsichtig	ANT
Anomalie	Normalität	ANT
vorgreifen	Bieten	HYPER
bewusst	unbewusst	ANT
mutig	Cannabis	RANDOM
Anhänger	Ausrüstung	PART_OF
ausschließen	zuvorkommen	SYN
Sendung	Wird geladen	SYN
unkenntlich	unklar	SYN
hacken	mild	RANDOM
Badewanne	Planet	RANDOM
Querruder	Flugzeug	PART_OF
Geburt	Farbe	RANDOM
stolpern	gehen	HYPER
Sequenz	Film	PART_OF
Organ	Klinge	RANDOM
Kreis	springen	RANDOM
Urquell	Quelle	HYPER
Elend	Experiment	RANDOM
Gefährlichkeit	Bedingung	HYPER
Wiederholung	Übertragung	HYPER
prasseln	Sermon	SYN
nichts	glücklich	RANDOM
Harnröhre	Vulva	PART_OF
Rate	Serie	PART_OF
Mobbing	Verhalten	HYPER
Sprungball	Basketball	PART_OF
downs	Theater	PART_OF
Hyazinthe	jacinth	SYN
verringert	erhöht	ANT
Backe	Homo	PART_OF
dl	dal	PART_OF
Radius	Wagenrad	PART_OF
erschrecken	Schrecken	HYPER
Koloss	Dampfwalze	SYN
Eis	halt	RANDOM
Borte	Wandteppich	PART_OF
primär	Sekundär-	ANT
singen	aussprechen	HYPER
Arithmetik	enorm	RANDOM
heiß	Lächeln	RANDOM
Mikrosekunde	Sekunde	PART_OF
snit	Reizung	HYPER
Minister	Residenz	RANDOM
komisch	komisch	SYN
Mittagessen	Fernsehen	RANDOM
Mastoid	braincase	PART_OF
stumpf	roh	SYN
Schlafzimmer	leiden	RANDOM
Kathode	Tube	PART_OF
schub	Reversion	SYN
Export	einführen	ANT
Ast	positiv	RANDOM
Cent	leone	PART_OF
Runway	Start- und Landebahn	PART_OF
schmettern	Geschrei	SYN
betreffen	verweisen	SYN
China	Freundin	RANDOM
Herstellung	einfach	RANDOM
perfekt	sitzen	RANDOM
Gyrus	Großhirn	PART_OF
Bett	Fräulein	RANDOM
einbüßen	Verwirkung	SYN
Marodeur	Täter	HYPER
Mittelfeld	Arena	PART_OF
hypnotisieren	beeinflussen	HYPER
Elch	Wapiti	SYN
Jade	Schlampe	SYN
Unterseite	Torso	PART_OF
Tragblatt	Schale	HYPER
Angelegenheit	Streifen	RANDOM
Flottille	Anhäufung	HYPER
faul	Geschichte	RANDOM
schlagen	stolpern	SYN
Gurt	Shimmy	PART_OF
drohen	informieren	HYPER
Historismus	Konzept	HYPER
Pöbel	Rotte	SYN
Beste	am schlimmsten	ANT
Bequemlichkeit	Unbequemlichkeit	ANT
gesund	unhealthful	ANT
durchsetzbar	nicht durchsetzbar	ANT
Mesh	im	PART_OF
bunt	farblos	ANT
Nahrung	Instandhaltung	SYN
essbar	ungenießbar	ANT
Torheit	Weisheit	ANT
Amerika	Nische	RANDOM
hydrophile	hydrophober	ANT
Lohn	Lohn-und Gehaltsabrechnung	PART_OF
Triebfeder	Uhrwerk	PART_OF
Vermeidung	Ausweichen	SYN
gemildert	ungemildert	ANT
herrisch	swaggering	SYN
Unaufrichtigkeit	Aufrichtigkeit	ANT
appointive	Wahl-	ANT
Leben	Entspannen Sie Sich	RANDOM
Eingetragen	nicht eingetragen	ANT
Thalamus	forebrain	PART_OF
dal	hl	PART_OF
synchronisieren	veredeln	HYPER
unten	unter	SYN
Ausrüstung	Mobilisierung	HYPER
Ader	Reaktor	PART_OF
erscheinen	Experiment	RANDOM
unmerklich	spürbar	ANT
Kupplung	Kupplung	PART_OF
Gründen	Ursache	HYPER
Klassenzimmer	Schulzimmer	SYN
kommerziell	Werbung	HYPER
geflügelt	ohne Flügel	ANT
Murmeln	Verstand	SYN
Zusatz	Subtraktion	ANT
Dachs	ärgern	HYPER
Kätzchen	lehren	RANDOM
Darsteller	mild	RANDOM
Farbe	Glanz	SYN
Ur	Ochse	HYPER
Athlet	Meister	RANDOM
Sprache	Strand	RANDOM
Kriegslust	Aggressivität	HYPER
unerträglich	erträglich	ANT
Skrupel	zögern	HYPER
Unze.	Pfund	PART_OF
Bar	Sie	RANDOM
Lack	verschönern	HYPER
Unfall	beschränken	RANDOM
schön	Mut	RANDOM
Orient	verdrängen	HYPER
Episkopat	Bischofsamt	SYN
Minderwertigkeit	Überlegenheit	ANT
Asymmetrie	Symmetrie	ANT
einsprachig	mehrsprachig	ANT
Kreis	Ideologie	RANDOM
Spezialistentum	Spezialisierung	SYN
Schaufel	Propeller	PART_OF
uptick	Behandlung	HYPER
beschämend	schockierend	SYN
Chicoree	Chicoree	PART_OF
brüllen	jammern	SYN
Abwesenheit	Gegenwart	ANT
verrückt	bekloppt	SYN
Oma	Vorfahr	HYPER
unveränderlich	Variable	ANT
Thron	kann	PART_OF
störend	beunruhigt	SYN
Strand	Stock	RANDOM
Geige	Reparatur	HYPER
Schaft	Bratpfanne	PART_OF
Schwall	Ausbruch	SYN
laut	leise	ANT
Choke	Schaltung	PART_OF
Abschleppwagen	Arbeiter	HYPER
Vergaser	Vergaser	SYN
Absorption	Aussterben	PART_OF
Hernie	Verletzung	HYPER
Überfall	kämpfen	HYPER
jubeln	messen	HYPER
herb	unnachgiebig	SYN
asymmetrisch	asymmetrisch	SYN
möglich	rentabel	SYN
Jahrhundert	Millennium	PART_OF
Atemloch	Atemwegs	PART_OF
Schlecht	Mobiltelefon	RANDOM
Wolke	mächtig	RANDOM
Kalb	Schuh	RANDOM
Hoffnung	Becher	RANDOM
Berufung	Berufung	SYN
reingehen	Übeltäter	HYPER
bestimmt	unbestimmt	ANT
Straßenbahn	Instrumentierung	HYPER
Inventar	Produkt	HYPER
Manöver	Taktik	SYN
Trennung	Meiose	PART_OF
Lektion	Pädagogie	PART_OF
Menschheit	Stift	RANDOM
hilfreich	nicht hilfreich	ANT
gleiten	Segeln	SYN
Mittagessen	Gerechtigkeit	RANDOM
Base	Schriftsteller	RANDOM
maxi	Midi-	ANT
Feuersbrunst	Auftreten	HYPER
Agitation	Ruhe	ANT
pintle	Scharnier	PART_OF
Ignoranz	Tatsache	RANDOM
Widerstand	Schaltung	PART_OF
vorspannen	Handlung	RANDOM
Hügel	Reiten	RANDOM
Türsteher	Porter	SYN
Bild	Rauch	RANDOM
Faktor	Kern	PART_OF
Kern	Summe	SYN
versteifen	Randstein	HYPER
bereit	unvorbereitet	ANT
Beurteilung	Beurteilung	SYN
funkelnd	immer noch	ANT
Schlafgemach	Aufenthalt	PART_OF
Schwierigkeit	Leichtigkeit	ANT
Nahkampf	Kampf	HYPER
Goldschmied	Hersteller	HYPER
mögen	draußen	RANDOM
Latex	Emission	HYPER
schwarz	Beschädigung	RANDOM
Mondstrahl	Mondschein	PART_OF
Blatt	Bürste	RANDOM
Ast	Teilt	RANDOM
Zylinder	Taucherlunge	PART_OF
betäuben	ändern	HYPER
lehnen	Reich	ANT
7	Sieben	SYN
Umfrage	Pferd	PART_OF
144	brutto	SYN
Streifen	Ereignis	HYPER
Gehorsamsverweigerung	Unterordnung	ANT
Einsatz	Kleidungsstück	PART_OF
bedingt	bedingungslos	ANT
Licht	müßig	RANDOM
Kindermädchen	Kindermädchen	SYN
aktiv	Tonhöhe	RANDOM
ratsam	nicht ratsam	ANT
Kajak	Kanu	HYPER
behandelt	unbehandelt	ANT
abholen	Grammophon	PART_OF
Komplize	Eidgenosse	SYN
wackeln	wackeln	HYPER
Produkt	Ware	HYPER
lose	Reise	RANDOM
Wellensittich	Turteltaube	SYN
Halfter	Kopfbedeckung	HYPER
Band	Fass	PART_OF
perinatal	pränatal	ANT
Deflation	Inflation	ANT
Entwurf	Entwurf	SYN
trocken	lakonisch	SYN
Jimmy	Hebel	SYN
Schild	Poop	PART_OF
Sauerstoff	Lüge	RANDOM
kontinental	interkontinental	ANT
Erzähler	Lügner	HYPER
Pferd	Macht	HYPER
Auspuff	Auto	PART_OF
Schakal	Eckzahn	HYPER
Schienen	Straßenbahnlinie	PART_OF
schwanken	ändern	HYPER
einatmen	inspirieren	SYN
laut	Demokratie	RANDOM
angebracht	freistehend	ANT
Degradierung	Beförderung	ANT
Kriechgang	Gebäude	PART_OF
Preis-	Trophäe	SYN
stornieren	kratzen	SYN
agnostisch	Gnostiker	ANT
Kontrast	abweichen	HYPER
vollständig	ausschließlich	SYN
Sektor	Schlachtfeld	PART_OF
Behälter	Engel	RANDOM
Chiffre	Postleitzahl	SYN
Transit	Infrastruktur	PART_OF
heulen	Heulen	SYN
Runway	Straßenbahn	PART_OF
Hinweis	Menschheit	RANDOM
Pirat	Schwerverbrecher	HYPER
Guave	Guave	PART_OF
müßig	Bürste	RANDOM
mehrere	Single	ANT
detektiert	unentdeckt	ANT
motored	motorisiert	SYN
Vertrautheit	Fremdheit	ANT
Phantasie	Tür	RANDOM
nichts	führen	RANDOM
Spinnrocken	Kugel	HYPER
betäuben	Randstein	HYPER
Verfolgung	Hinter	SYN
gegenseitig	gegenseitig	SYN
Boss	politisch-	HYPER
Nation	Bürgersteig	RANDOM
Schaft	Zapfen	PART_OF
Heckflosse	Auto	PART_OF
exemplarisch	Modell-	SYN
Donner	äußern	HYPER
Bolzen	Schimmel	RANDOM
Unschärfen	Präzision	ANT
entwischen	ausweichen	SYN
Park	Gummi	RANDOM
Butter	Flug	RANDOM
Eierlikör	schlagen	HYPER
zugänglich	nicht zugänglich	ANT
Schüssel	Erklärung	RANDOM
unveränderlich	veränderlich	ANT
Beiname	Charakterisierung	HYPER
Dumping	Merkantilismus	HYPER
Hemisphäre	Großhirn	PART_OF
Remission	Rettung	HYPER
Zahl	soma	SYN
Deckel	Empfangshalle	RANDOM
Elend	Geschenk	RANDOM
Leichentuch	Heftzwecke	SYN
Armut	Reichtum	ANT
verlieren	Experiment	RANDOM
Stufe	Treppe	PART_OF
unterstützt	rückenfrei	ANT
Parkett	Theater	PART_OF
Tempo	Barsch	PART_OF
multinomial	Polynom	SYN
Bewegung	Aussicht	RANDOM
prinzipien	prinzipienlos	ANT
riskant	zweifelhaft	SYN
Zufriedenheit	Unzufriedenheit	ANT
Seetaucher	Bummler	HYPER
bitten	anfordern	HYPER
ermöglichen	schätzen	HYPER
Stärke	Klavier	ANT
mies	doof	SYN
Fluch	whammy	SYN
Postleitzahl	Festsetzung	HYPER
Auftragnehmer	jemand	HYPER
downtick	uptick	ANT
Manschette	Ärmel	PART_OF
überweisen	warten	HYPER
kehlig	Konsonant	HYPER
Campingplatz	Seite? ˅	HYPER
hao	Schwanz	PART_OF
Plebejer	ungewaschen	SYN
Hüfte	Becken	PART_OF
Land	drücken	RANDOM
Teig	Kohle	SYN
Beschäftigung	Arbeitslosigkeit	ANT
Osmose	Dialyse	PART_OF
Harfen	Musiker	HYPER
Pocke	Variola	PART_OF
Einberufung	Exorzismus	PART_OF
Agonisten	Gegner	ANT
blass	Kette	RANDOM
erheben	Militarisierung	HYPER
Rippe	Kommentar	HYPER
stachelig	stachelig	SYN
wiedergewinnbar	unrecoverable	ANT
unklug	diplomatisch	ANT
künstlich	unnatürlich	SYN
Staubbeutel	blühen	PART_OF
cabana	Schutz	HYPER
twosome	Joch	SYN
damselfish	Prachtlibelle	SYN
verschlafen	unscharf	SYN
Nelke	Knospe	HYPER
Grafik	Veröffentlichung	PART_OF
Erfrierung	Verletzung	HYPER
Verwechslung	Compoundierung	HYPER
Kampagne	Kreuzzug	SYN
Nominativ	schräg	ANT
Fröhlichkeit	Temperament	PART_OF
Blatt	Teilen	RANDOM
auslassen	Atemwegs	PART_OF
anhäufen	Konglomerat	SYN
Turbofan	Turbostrahltriebwerk	PART_OF
Potpourri	Zusammensetzung	HYPER
Ratte	Haube	PART_OF
nevus	beschädigen	HYPER
rechtmäßig	ungesetzlich	ANT
Schlepper	Konstrukteur	HYPER
Unsicherheit	Sicherheit	ANT
Schredder	Vermittlung	HYPER
absurd	unsinnig	SYN
knabbern	Byte	PART_OF
Kanone	Zweifüßer	PART_OF
beschäftigt	Wohnung	RANDOM
benennen	ernennen	HYPER
Menschen	Abstraktion	HYPER
Häftling	Häftling	HYPER
Haufen	Stapel	SYN
Unähnlichkeit	Ähnlichkeit	ANT
Engpass	stymie	HYPER
Pantheismus	Theismus	HYPER
Diabetiker	Leidende	HYPER
Landung	Treppe	PART_OF
Abenteuer	Gefahr	SYN
Zündung	Beleuchtung	SYN
wilde	Primitive	HYPER
Schlag	Brief	RANDOM
Fleisch	gelingen	RANDOM
Brust	Bein	RANDOM
invasive	nicht-invasiv	ANT
Wette	Schwimmbad	PART_OF
ätzend	schweflig	SYN
Ellbogen	Arm	PART_OF
Bahre	Gebäude	PART_OF
Marder	Fleischfresser	HYPER
Teehaus	Gebäude	HYPER
Artillerie	Macht	HYPER
Abend	Nacht	PART_OF
gestischen	nonverbale	SYN
Bar	Saloon	PART_OF
Schönheit	nicht nett	RANDOM
Skelett-	verschwendet	SYN
geplant	außerplanmäßig	ANT
entschuldbar	verzeihlich	SYN
Ökumenismus	Glaubensbekenntnis	HYPER
Arithmetik	Topf	RANDOM
Vertrautheit	Fremdheit	ANT
Merkmal	jemand	PART_OF
scharrt	Kauen	HYPER
Wolke	Galaxis	RANDOM
Babysitter	Modell-	HYPER
Anhänger	Halskette	PART_OF
distributary	Nebenfluss	ANT
Verschiebung	Werktag	PART_OF
gefürchtet	entsetzlich	SYN
Fülle	Knappheit	ANT
Maniok	Maniok	PART_OF
Hellebarde	Arm	HYPER
Palme	Arm	PART_OF
Abschreckung	Abschreckungs	SYN
alt	Lebensmittel	RANDOM
reinigen	kleiden	RANDOM
studierte	ungekünstelt	ANT
Blau	würzig	SYN
Zuneigung	glatt	RANDOM
verbindend	disjunctive	ANT
Rock	Kleidungsstück	PART_OF
Telomer	Chromosom	PART_OF
vergötterte	vergötterte	SYN
Kurat	Pastor	SYN
Hyperglykämie	Hypoglykämie	ANT
Episkopat	Gruppierung	HYPER
Lunge	Anweisung	RANDOM
bürgerlich	siderisch	ANT
Duft	verbessern	HYPER
44	vierundvierzig	SYN
Hebelwirkung	leveraging	SYN
privat	öffentlich	ANT
Bogen	Türöffnung	RANDOM
Kortex	Mark	ANT
Verkauf	Großhandel	ANT
Lappen	Woche	HYPER
lepton	Drachme	PART_OF
Zitat	Extrakt	HYPER
müßig	Neutron	RANDOM
Weichheit	Toleranz	HYPER
abgeneigt	geneigt	ANT
penstock	Schleuse	PART_OF
Sensation	Magier	SYN
Münster	Kloster	PART_OF
Beschäftigung	Arbeitslosigkeit	ANT
Innereien	Eingeweide	SYN
raphe	Hodensack	PART_OF
Mikrometer	Millimeter	PART_OF
Formalismus	Nachahmung	ANT
beladen	besoffen	SYN
Veränderung	Motorrad	RANDOM
genau	ungenau	ANT
Bewegung	Leicht	RANDOM
Taube	Falke	ANT
sperren	weit	RANDOM
Wiedergabe	Recorder	PART_OF
Ekel	Sauberkeit	HYPER
muller	implementieren	HYPER
Hersteller	Former	HYPER
Uhr	Gemüse	RANDOM
melodisch	tuneless	ANT
dokumentiert	nicht dokumentiert	ANT
Fleisch	Hobby	RANDOM
Zinnober	vermillion	SYN
bevorzugen	benennen	HYPER
Lunge	Tag	RANDOM
Minarett	Moschee	PART_OF
Sonnenbrand	Sonnenbräune	SYN
Fräulein	Tabelle	RANDOM
konvulsiv	spastisch	SYN
Ausrichtung	Organisation	HYPER
genug	Menge	HYPER
personifizieren	verkörpern	HYPER
Wanne	Wohnung	PART_OF
Welle	Speer	SYN
Hiatus	Unterbrechung	HYPER
Linse	Wort	RANDOM
Kokos-	Ballaststoff	HYPER
Kühle	Ruhe	HYPER
Gürtel	Sieg	RANDOM
gemalt	unbemalt	ANT
Vorhaut	Vulva	PART_OF
Schinderei	Schnecke	SYN
Christian	unzufrieden	RANDOM
Kennzeichen	Langeweile	RANDOM
erfordern	benötigen	SYN
Präparatoren	Kunst	HYPER
Mandel	Kehle	PART_OF
Quirl	Haube	PART_OF
vereiteln	Pest	SYN
verletzt	mild	RANDOM
Fensterscheibe	Gebäude	PART_OF
Zelle	aufrecht	RANDOM
con	Profi	ANT
Armut	Reichtum	ANT
jährlich	beständig	ANT
Spitze	Pfeilspitze	PART_OF
Mikrometer	Millimeter	PART_OF
Fettuccine	Pasta	HYPER
verrückt	nussartig	SYN
unerschütterlich	unerschütterlich	SYN
Gehorsamsverweigerung	Unterordnung	ANT
Praxis	Tat	HYPER
Saugnapf	Saugnapf	PART_OF
Hügel	Hügel	SYN
Altphilologe	romanticist	ANT
naturalistisch	realistisch	SYN
laut	Himmel	RANDOM
Anzeigetafel	Tafel	HYPER
verlieren	Union	RANDOM
proaktive	rückwirkend	ANT
Mandel	Mandel	PART_OF
Shoji	versteckt	HYPER
Stirn	braincase	PART_OF
Schleudern	Rutsche	PART_OF
Dynamik	Kraft	SYN
mögen	Ventilator	RANDOM
Knochen	hören	RANDOM
verlieren	Mode	RANDOM
lästig	Scheuern	SYN
offline	online	ANT
Unabhängigkeit	Mannschaft	RANDOM
Geißel	Sperma	PART_OF
alt	Krankheit	RANDOM
Packer	Fußzeile	HYPER
besoffen	slicked	SYN
Krankheit	Paar	RANDOM
Bogen	Pflege	RANDOM
Flugzeug	Komplex	RANDOM
Klasse	Droge	RANDOM
Überproduktion	überrennen	SYN
Vamp	Oberer	PART_OF
Nachdenklichkeit	Persönlichkeit	PART_OF
Heuchler	Betrüger	HYPER
Widerhaken	Haken	PART_OF
coney	das	SYN
Aussehen	Verschwinden	ANT
unentschlossen	entschlossen	ANT
Anker	Kühlschrank	PART_OF
typisch	uncharakteristisch	ANT
Kumpel	Kumpan	SYN
Licht	Individuell	RANDOM
Linie	reifen	RANDOM
Schulter	Kleidungsstück	PART_OF
gammelig	wertlos	SYN
Erbstück	Erbe	PART_OF
Marke	benennen	HYPER
Allgemeinheit	Besonderheit	ANT
exterritorial	territorial	ANT
Verspritzen	Splatter	SYN
qualitativ	quantitativ	ANT
Schaft	Vierfüßler	PART_OF
aufbringen	sagen	HYPER
Aufrichtigkeit	Natürlichkeit	HYPER
elastisch	Artefakt	HYPER
verletzt	Center	RANDOM
ng	Milligramm	PART_OF
Thron	Aufenthalt	PART_OF
Schneiden	Karten	PART_OF
Gehäuse	Gebäude	PART_OF
Palisade	umgeben	SYN
agitieren	wecken	SYN
Schönheit	Ideal	HYPER
heiß	ungewöhnlich	RANDOM
Fehlbarkeit	Unfehlbarkeit	ANT
Angebot	Pose	HYPER
Schleudern	rutschen	PART_OF
Zivilist	serviceman	ANT
porter	boeuf	PART_OF
studentship	Position	HYPER
beschreiben	erarbeiten	HYPER
Kurta	Kleidungsstück	HYPER
Karikaturist	Zeichner	HYPER