orb	revolve	SYN
magician	wizard	SYN
brave	reason	RANDOM
buy	spread	RANDOM
probe	inquiry	HYPER
electrode	battery	PART_OF
ordinary	waterfall	RANDOM
clarion	exclaim	HYPER
negativity	positivity	ANT
amidships	midships	SYN
relishing	savouring	SYN
walnut	walnut	PART_OF
bias	team	RANDOM
expansive	talkative	SYN
narration	message	HYPER
pasturage	pasture	SYN
boiler	building	PART_OF
changer	phonograph	PART_OF
noncombatant	serviceman	HYPER
bilberry	bilberry	PART_OF
keyboard	unhappy	RANDOM
hopefulness	hopelessness	ANT
bema	church	PART_OF
birthday	sky	RANDOM
conductor	insulator	ANT
pigeonhole	stereotype	SYN
laggard	layabout	HYPER
process	command	HYPER
object	silent	RANDOM
brain	radio	RANDOM
pectoralis	vertebrate	PART_OF
bar	plot	RANDOM
employable	unemployable	ANT
gorgeously	magnificently	SYN
emphatic	forceful	SYN
waning	waxing	ANT
cent	guilder	PART_OF
leek	leek	PART_OF
arctic	gumshoe	SYN
opal	gem	HYPER
subsidence	collapse	HYPER
noise	leave	RANDOM
salesmanship	acquisition	HYPER
aisle	good	RANDOM
stuff	belongings	HYPER
arena	bowl	SYN
rich	robust	SYN
airplane	plant	RANDOM
censored	uncensored	ANT
generalisation	learning	HYPER
asia	toe	RANDOM
moolah	wampum	SYN
rumen	ruminant	PART_OF
hardiness	validity	SYN
shield	mollusk	PART_OF
apron	transit	PART_OF
aggregator	being	HYPER
recall	intend	HYPER
appointment	determination	HYPER
performer	someone	HYPER
existent	nonexistent	ANT
demonstrative	illustrative	SYN
eff	pair	HYPER
peccary	ungulate	HYPER
wilding	rampage	HYPER
punctuality	tardiness	ANT
whir	occurrence	HYPER
nose	metal	RANDOM
reversal	turnabout	SYN
effective	ineffective	ANT
highland	lowland	ANT
kilobyte	gigabyte	PART_OF
fresh	preserved	ANT
brute	fauna	SYN
qualified	unqualified	ANT
defined	outlined	SYN
augur	omen	SYN
mark	care	RANDOM
illness	coach	RANDOM
subtitle	flick	PART_OF
claw	assail	HYPER
activator	inhibitor	ANT
nobleman	noblewoman	ANT
insufferable	unacceptable	SYN
impracticality	practicality	ANT
cold-blooded	warm-blooded	ANT
unrivaled	unrivalled	SYN
chair	tool	RANDOM
effacement	travail	PART_OF
athlete	hard	RANDOM
eyeball	oculus	PART_OF
beautiful	letter	RANDOM
humongous	thumping	SYN
coalesce	merge	SYN
actuate	prompt	SYN
member	hallway	RANDOM
manioc	cassava	HYPER
imperious	prideful	SYN
heaviness	lightness	ANT
tinsel	modify	HYPER
crackdown	prevention	HYPER
leak	reverse	RANDOM
predictability	unpredictability	ANT
downtown	uptown	ANT
implausibility	plausibility	ANT
calf	shout	RANDOM
important	unimportant	ANT
chicken	matter	RANDOM
pica	inch	PART_OF
lull	hush	HYPER
guilt	innocence	ANT
co-ordinated	coordinated	SYN
hyperglycemia	hypoglycemia	ANT
paid	paying	SYN
mind	shade	RANDOM
accord	harmonise	SYN
gully	valley	HYPER
strut	swagger	SYN
scramble	agitate	HYPER
bowel	stomach	PART_OF
summery	wintry	ANT
discipline	indiscipline	ANT
immodestly	modestly	ANT
confusion	disarray	SYN
bulkhead	partition	HYPER
punch	perforate	HYPER
acidity	alkalinity	ANT
burdened	unburdened	ANT
china	poison	RANDOM
cl	l	PART_OF
moneymaker	programme	HYPER
cropper	jack	HYPER
basketball	vacuum	RANDOM
mean	game	RANDOM
thole	dinghy	PART_OF
frivolity	seriousness	ANT
antonym	synonym	ANT
clinch	constraint	HYPER
resale	merchandising	HYPER
changeover	shift	HYPER
butcher	slaughter	SYN
jaw	caput	PART_OF
jacket	short	RANDOM
displacement	translation	HYPER
blowhole	blower	PART_OF
citron	citron	PART_OF
troubled	untroubled	ANT
curse	cuss	SYN
mountain	speak	RANDOM
exterminate	uproot	SYN
front	battleground	PART_OF
monism	pluralism	ANT
twilight	eve	PART_OF
approval	disapproval	ANT
convincing	unconvincing	ANT
viceroyalty	jurisdiction	HYPER
stencil	print	HYPER
boat	lift	RANDOM
narrowing	widening	ANT
pacifism	doctrine	HYPER
matrix	os	PART_OF
happily	merrily	SYN
pay	skin	RANDOM
breast	dwell	RANDOM
femininity	masculinity	ANT
cooked	raw	ANT
despair	hope	ANT
antecedent	subsequent	ANT
generic	varietal	ANT
loader	workman	HYPER
bur	pericarp	HYPER
beef	sunshine	RANDOM
fizz	potable	HYPER
kilogram	metric	HYPER
angstrom	micron	PART_OF
radome	aeroplane	PART_OF
conservative	liberal	ANT
anode	circuit	PART_OF
class	big	RANDOM
pledge	portion	HYPER
age	life-time	PART_OF
bedevil	hassle	HYPER
sin	transgress	HYPER
cram	ready	HYPER
loose	head	RANDOM
relegation	compartmentalization	HYPER
maximum	minimum	ANT
me	trial	RANDOM
irreversibility	reversibility	ANT
treatment	deed	HYPER
pledge	prize	HYPER
chewing	feeding	PART_OF
call	support	RANDOM
pace	walking	PART_OF
countertop	tabletop	HYPER
mikado	emperor	HYPER
scorekeeper	adjudicator	HYPER
insensible	unaffected	SYN
nucleon	nucleus	PART_OF
discernible	evident	SYN
bit	democracy	RANDOM
hypertension	hypotension	ANT
dealer	trader	SYN
recommendation	testimonial	SYN
pestilence	determiner	HYPER
bumper	motorcar	PART_OF
irresponsibility	responsibility	ANT
direct	retrograde	ANT
desensitize	modify	HYPER
paraquat	herbicide	HYPER
new	star	RANDOM
ab	abdomen	PART_OF
mocking	quizzical	SYN
okay	authorize	HYPER
realistically	unrealistically	ANT
sharpness	softness	ANT
albumen	albumin	SYN
house	money	RANDOM
induced	spontaneous	ANT
jump	mortal	RANDOM
lb	quintal	PART_OF
bare	covered	ANT
financial	nonfinancial	ANT
here	there	ANT
disintegrate	alter	HYPER
meekness	submission	SYN
cede	surrender	SYN
drone	bagpipe	PART_OF
can	domicile	PART_OF
blossom	angiosperm	PART_OF
goose	nip	HYPER
offspring	tall	RANDOM
boundary	bounds	SYN
insectivorous	omnivorous	ANT
subsonic	supersonic	ANT
constitution	attribute	HYPER
tumbler	jock	HYPER
cannabis	disk	RANDOM
emancipator	liberator	HYPER
chatty	talky	SYN
plunge	concentrate	HYPER
empirically	theoretically	ANT
curmudgeonly	gruff	SYN
bather	someone	HYPER
collaborationist	collaborator	SYN
directly	forthwith	SYN
bunsen	etna	SYN
loading	unloading	ANT
slaughter	butchery	PART_OF
lobby	use	RANDOM
insincere	sincere	ANT
awkward	cumbersome	SYN
hinge	motorcar	PART_OF
earshot	reach	HYPER
cast	craps	PART_OF
matter	walk	RANDOM
conception	misconception	ANT
porthole	fuselage	PART_OF
struggle	try	HYPER
obscurity	prominence	ANT
damaged	undamaged	ANT
clapper	pharynx	PART_OF
advance	retreat	ANT
drumlin	mass	HYPER
morning	fragile	RANDOM
level	woman	RANDOM
mississippi	vehicle	RANDOM
unschooled	untutored	SYN
air-to-air	air-to-surface	ANT
offshore	onshore	ANT
basketball	personal	RANDOM
knot	dream	RANDOM
fig	illustration	HYPER
chap	feller	SYN
graze	rake	SYN
stab	activity	HYPER
scripted	unscripted	ANT
keel	watercraft	PART_OF
postcode	missive	PART_OF
favorably	unfavorably	ANT
democratic	undemocratic	ANT
irksome	tedious	SYN
elaborate	elucidate	HYPER
bat	window	RANDOM
lock	star	RANDOM
knot	hour	RANDOM
core	magnet	PART_OF
vane	chopper	PART_OF
steadily	unsteadily	ANT
advance	sock	RANDOM
ground	restrain	HYPER
map	object	RANDOM
barrack	exalt	HYPER
mendacity	veracity	ANT
establishment	authorities	PART_OF
labour	pregnancy	PART_OF
leg	misunderstand	RANDOM
oxalis	sorrel	SYN
obliquity	pregnancy	PART_OF
pistachio	pistachio	PART_OF
courtship	prayer	HYPER
minor	venial	SYN
baldy	somebody	HYPER
falsehood	falsity	SYN
sclera	optic	PART_OF
fastball	delivery	HYPER
care	picture	RANDOM
chain	play	RANDOM
penis	industry	RANDOM
gossamer	see-through	SYN
exhort	rede	HYPER
canon	ravine	HYPER
condensation	condensing	SYN
sweeten	alter	HYPER
moonless	moonlit	ANT
competently	incompetently	ANT
sprocket	camera	PART_OF
nurse	nursemaid	SYN
midsection	torso	PART_OF
start	startle	SYN
civilization	bull	RANDOM
decision	indecision	ANT
beating	whipping	SYN
suturing	operation	PART_OF
criticality	crossroads	HYPER
alternate	opposite	ANT
diploid	haploid	ANT
wire	arrange	HYPER
actor	game	RANDOM
bat	material	RANDOM
mastication	eating	PART_OF
closet	short	RANDOM
paneling	building	PART_OF
watchfulness	attentiveness	HYPER
impotent	potent	ANT
desperately	urgently	SYN
lather	fizz	HYPER
medicine	gun	RANDOM
author	shallow	RANDOM
sweatpants	sweats	PART_OF
cachet	seal	HYPER
centralization	decentralization	ANT
ward	hospital	PART_OF
beginning	first	SYN
tunic	tunica	SYN
acquire	locate	HYPER
carry	view	RANDOM
divination	prophecy	SYN
heaven	region	HYPER
christian	vehicle	RANDOM
artist	war	RANDOM
repentant	unrepentant	ANT
illness	bathroom	RANDOM
fashionable	unfashionable	ANT
movement	mouse	RANDOM
shank	handcart	PART_OF
quarter	hundredweight	PART_OF
party	count	RANDOM
obligatory	optional	ANT
blustering	blustery	SYN
blame	blessed	SYN
order	proton	RANDOM
asia	instruction	RANDOM
maximum	minimum	ANT
impartiality	partiality	ANT
devil	nettle	SYN
clock	lot	RANDOM
assignation	meeting	HYPER
cracking	neat	SYN
return	response	HYPER
air	leave	RANDOM
analyst	psychoanalyst	SYN
incineration	combustion	HYPER
boost	promote	SYN
soy	soybean	PART_OF
whizz	zip	HYPER
sardine	chalcedony	HYPER
stator	blower	PART_OF
milliliter	dl	PART_OF
succor	succour	SYN
shooting	shot	SYN
rotor	chopper	PART_OF
flavour	tone	SYN
meager	stingy	SYN
toleration	permit	HYPER
boil	seethe	SYN
runway	tramline	PART_OF
circle	test	RANDOM
narthex	church	PART_OF
apple	mammal	RANDOM
falsify	manipulate	SYN
demise	life-time	PART_OF
steed	mount	HYPER
imperfection	perfection	ANT
nineties	period	HYPER
anchor	claw	HYPER
city	girlfriend	RANDOM
prow	watercraft	PART_OF
commencement	graduation	SYN
chilli	jalapeno	PART_OF
centre	sum	SYN
hit	chest	RANDOM
restoration	reparation	HYPER
annual	biennial	ANT
snarl	distort	HYPER
concentration	dilution	ANT
aunt	uncle	ANT
boy	right	RANDOM
pullover	garment	HYPER
uvula	palate	PART_OF
lattice	latticework	SYN
nonpayment	payment	ANT
gut	torso	PART_OF
cloud	sleep	RANDOM
roughness	smoothness	ANT
thymus	endocrine	HYPER
marketer	vendor	SYN
crazy	mad	SYN
lowered	raised	ANT
insoluble	soluble	ANT
competence	incompetence	ANT
irreversible	reversible	ANT
hip	rosebush	PART_OF
candy	dark	RANDOM
escarole	endive	PART_OF
swag	shake	HYPER
poll	pollard	SYN
mistake	book	RANDOM
germination	sprouting	SYN
filbert	hazel	PART_OF
red-brick	redbrick	SYN
gush	rave	SYN
jail	problem	RANDOM
movie	ram	RANDOM
fillet	helping	HYPER
constant	inconstant	ANT
stele	axis	PART_OF
buy	room	RANDOM
duplicate	check	HYPER
codicil	testament	PART_OF
clementine	citrus	HYPER
bag	acquire	HYPER
adventure	think	RANDOM
newbie	novice	HYPER
frivolous	serious	ANT
glib	slick	SYN
ascription	attribution	SYN
mustache	whiskers	PART_OF
captain	integrity	RANDOM
circulate	displace	HYPER
bracket	edit	HYPER
mirasol	helianthus	HYPER
cheesy	tinny	SYN
tangled	untangled	ANT
illustrate	instance	SYN
action	lid	RANDOM
bulgur	tabbouleh	PART_OF
bridge	hall	RANDOM
dramatize	embellish	SYN
sequence	pic	PART_OF
considerate	inconsiderate	ANT
impinge	trench	SYN
brain	unhappy	RANDOM
bridge	word	RANDOM
harness	chute	PART_OF
park	lot	RANDOM
leg	math	RANDOM
birthday	fear	RANDOM
hilltop	tip	HYPER
lease	dwell	RANDOM
scope	radar	PART_OF
ireland	strike	RANDOM
bend	mine	RANDOM
stator	smoother	PART_OF
shank	handset	PART_OF
roasting	cooking	HYPER
paper	plant	RANDOM
cere	nib	HYPER
hazelnut	hazel	PART_OF
draft	mobilization	HYPER
dirge	lament	SYN
account	sunshine	RANDOM
3	iii	SYN
squirt	discharge	HYPER
change	hand	RANDOM
liter	hectoliter	PART_OF
mass	spate	SYN
kobo	naira	PART_OF
channel	soul	RANDOM
consecrated	desecrated	ANT
leak	practice	RANDOM
ruffle	annoy	HYPER
cottonseed	cotton	PART_OF
chum	crony	SYN
admire	island	RANDOM
nontraditional	traditional	ANT
foreign	native	ANT
intimate	suggest	SYN
embellish	embroider	SYN
mean	poem	RANDOM
halter	harness	PART_OF
shaft	building	PART_OF
emperor	nymphalid	HYPER
playable	unplayable	ANT
fair	unfair	ANT
disturbance	combat	HYPER
juicy	red-hot	SYN
springer	colonnade	PART_OF
substructure	system	PART_OF
mountain	jump	RANDOM
slops	swill	SYN
lower	father	RANDOM
bumble	falter	SYN
controversial	uncontroversial	ANT
buffoonery	clowning	SYN
blow	solution	RANDOM
visa	passport	PART_OF
bar	present	RANDOM
farthing	specie	HYPER
matrix	bone	PART_OF
interference	noninterference	ANT
gallon	quarter	PART_OF
herbivorous	insectivorous	ANT
rift	alteration	HYPER
airplane	hard	RANDOM
early	late	ANT
alcoholic	nonalcoholic	ANT
rider	measure	PART_OF
lampshade	lamp	PART_OF
big	sunshine	RANDOM
filmy	see-through	SYN
physique	someone	PART_OF
spoke	cycle	PART_OF
nakedness	openness	SYN
recitation	course	PART_OF
old	sound	RANDOM
knot	album	RANDOM
itch	ache	HYPER
exhaustive	thorough	SYN
lunch	lift	RANDOM
throne	dwelling	PART_OF
bathtub	energetic	RANDOM
coated	uncoated	ANT
rejoinder	riposte	SYN
perusal	perusing	SYN
asdic	submarine	PART_OF
lens	enrage	RANDOM
direct	indirect	ANT
hole	unbroken	RANDOM
carriageway	superhighway	PART_OF
biotechnology	ergonomics	SYN
propose	declare	HYPER
chew	past	RANDOM
chocolate	down	RANDOM
bat	work	RANDOM
clock	jar	RANDOM
car	element	RANDOM
monetize	legitimize	HYPER
blockade	obstruct	SYN
gatekeeper	cause	HYPER
impatience	patience	ANT
midi	mini	ANT
barbecue	picnic	HYPER
canvas	background	HYPER
carmine	cerise	SYN
scurry	speed	HYPER
imperial	purple	SYN
taro	taro	PART_OF
insured	uninsured	ANT
spare	portion	HYPER
macula	oculus	PART_OF
chevy	hassle	SYN
downslope	incline	HYPER
custom-made	ready-made	ANT
seamed	seamless	ANT
arrange	coiffure	SYN
chomping	mastication	HYPER
archduchess	princess	HYPER
wrist	arm	PART_OF
accompanying	attendant	SYN
efficiency	inefficiency	ANT
cancer	sport	RANDOM
osteopath	expert	HYPER
civilization	family	RANDOM
divan	lounge	HYPER
heterosexual	stage	RANDOM
chair	song	RANDOM
popularity	unpopularity	ANT
aid	cave	RANDOM
corneum	cuticle	PART_OF
retail	wholesale	ANT
officially	unofficially	ANT
aisle	weed	RANDOM
30	xxx	SYN
shaded	unshaded	ANT
override	reign	HYPER
gritty	spunky	SYN
battalion	plurality	SYN
lid	pretend	RANDOM
schoolhouse	infrastructure	PART_OF
faint	syncope	SYN
embracing	clench	HYPER
brave	spot	RANDOM
atonal	tonal	ANT
discovery	uncovering	SYN
aisle	engage	RANDOM
judge	recess	RANDOM
seasoned	unseasoned	ANT
fable	legend	SYN
wrapping	artifact	HYPER
figure	someone	PART_OF
bosom	garment	PART_OF
elastic	inelastic	ANT
vulva	privates	HYPER
buffoonish	clownish	SYN
acquaintance	stranger	ANT
apple	post	RANDOM
divisible	indivisible	ANT
sector	block	PART_OF
basketball	far	RANDOM
annex	addition	HYPER
lie	vehicle	RANDOM
distort	tinge	SYN
self-awareness	knowing	HYPER
here	there	ANT
channel	stock	RANDOM
compression	decompression	ANT
bury	lay	HYPER
guided	unguided	ANT
integration	segregation	ANT
gull	betray	HYPER
boat	ideology	RANDOM
soybean	soy	PART_OF
casing	threshold	PART_OF
assuming	presumptuous	SYN
bagging	sacking	SYN
lyric	level	RANDOM
cytokinesis	meiosis	PART_OF
honesty	illuminate	RANDOM
exterior	interior	ANT
suppressor	gene	HYPER
shut	prevent	HYPER
birthday	democracy	RANDOM
downriver	upriver	ANT
temptation	influence	HYPER
antiquated	archaic	SYN
beak	scale	RANDOM
injure	tree	RANDOM
foreground	punctuate	HYPER
machine	kill	RANDOM
rout	withdraw	HYPER
perfidious	treacherous	SYN
alternate	understudy	SYN
member	positive	RANDOM
underpants	pantyhose	PART_OF
almost	near	SYN
fatness	leanness	ANT
eliminate	release	HYPER
slickness	trickery	SYN
restrain	inhibit	HYPER
canvas	canvas	HYPER
acceptance	rejection	ANT
capacitance	circuit	PART_OF
coherence	incoherence	ANT
blood-red	ruddy	SYN
clock	spit	RANDOM
lap	garment	PART_OF
period	eon	PART_OF
heathland	wasteland	HYPER
outspoken	plainspoken	SYN
telescope	crush	HYPER
jog	gang	RANDOM
ocean	distress	RANDOM
chuckle	utterance	HYPER
singularity	individualism	HYPER
illness	soil	RANDOM
jaw	chuck	PART_OF
antimicrobial	disinfectant	SYN
independence	head	RANDOM
kilowatt	megawatt	PART_OF
birth	weapon	RANDOM
skull	caput	PART_OF
draught	portion	HYPER
antagonistic	conciliatory	ANT
pen	ram	RANDOM
majority	minority	ANT
blooper	boner	SYN
impractical	practical	ANT
ascent	descent	ANT
monsoon	downfall	HYPER
cardinal	central	SYN
arb	bourgeois	HYPER
lullaby	vocal	HYPER
savoring	feeding	HYPER
incision	surgery	PART_OF
gauze	patch	PART_OF
bonanza	windfall	SYN
terror	scamp	HYPER
stiffen	check	HYPER
counterrevolutionary	revolutionary	ANT
g	hg	PART_OF
floppy	platform	PART_OF
haft	brand	PART_OF
lemon	yellow	HYPER
millimetre	cm	PART_OF
ball	marry	RANDOM
endogamy	exogamy	ANT
leaf	shout	RANDOM
moonbeam	moonlight	PART_OF
white	eggs	PART_OF
limbed	limbless	ANT
headstone	tombstone	SYN
awkward	graceful	ANT
liquid	flight	RANDOM
kumquat	kumquat	PART_OF
hollow	prison	RANDOM
index	play	RANDOM
eighties	eld	PART_OF
lazy	rank	RANDOM
geminate	displace	HYPER
beset	molest	SYN
quickening	gestation	PART_OF
leaky	tight	ANT
bunt	hit	HYPER
map	side	RANDOM
fourth	quarter	SYN
life	job	RANDOM
marrow	sum	SYN
pay	play	RANDOM
middle-class	upper-class	ANT
hunt	gild	HYPER
general	specific	ANT
stump	lattice	PART_OF
crosswise	lengthwise	ANT
glorious	inglorious	ANT
boyfriend	grip	RANDOM
haemorrhagic	hemorrhagic	SYN
authoritative	classical	SYN
boredom	culture	RANDOM
diorama	panorama	SYN
waterbird	waterfowl	SYN
crystalized	glace	SYN
belief	human	RANDOM
bin	leaf	RANDOM
adequately	inadequately	ANT
maker	concern	HYPER
couplet	twosome	SYN
husk	stalk	SYN
cashew	cashew	PART_OF
key	sugar	RANDOM
reconstruct	evaluate	HYPER
medicine	chain	RANDOM
installing	installment	SYN
cm	dm	PART_OF
endogamous	exogamous	ANT
mandarin	mandarin	PART_OF
interdependence	mutuality	SYN
quizzical	teasing	SYN
honor	position	HYPER
ligament	musculature	PART_OF
finished	unfinished	ANT
scrapheap	cumulus	HYPER
funk	recoil	SYN
faggot	embroider	HYPER
mercury	forest	RANDOM
faithfulness	unfaithfulness	ANT
intangible	tangible	ANT
counterfeit	genuine	ANT
bones	clappers	SYN
disorganized	organized	ANT
availability	unavailability	ANT
mutual	reciprocal	SYN
voucher	supporter	HYPER
plural	singular	ANT
cleft	dissected	SYN
articulate	supply	HYPER
biting	bitter	SYN
yam	yam	PART_OF
hollow	skeleton	RANDOM
keystone	arcade	PART_OF
comedian	comic	SYN
disclaim	negate	HYPER
disproportion	proportion	ANT
exclusively	solely	SYN
gearbox	case	HYPER
weightless	weighty	ANT
resilience	snap	HYPER
achieve	reach	SYN
inhalation	breathing	PART_OF
gauss	tesla	PART_OF
deference	civility	HYPER
pentobarbital	barbiturate	HYPER
principal	loan	PART_OF
insolation	therapy	HYPER
wager	speculation	HYPER
grumbling	rumbling	SYN
curtailment	length	HYPER
facial	caput	PART_OF
ball	needle	RANDOM
seatbelt	airliner	PART_OF
cellophane	wrapping	HYPER
pen	death	RANDOM
heavy-duty	light-duty	ANT
sweatshirt	sweatsuit	PART_OF
gray	grizzly	SYN
floorboard	motorcar	PART_OF
drumstick	fowl	PART_OF
branded	unbranded	ANT
cavalcade	procession	HYPER
aah	verbalize	HYPER
fortunate	unfortunate	ANT
brawn	strength	HYPER
atheism	theism	ANT
generate	render	SYN
calyx	bloom	PART_OF
carriageway	thruway	PART_OF
clean	weather	RANDOM
newspaperman	journalist	HYPER
coldhearted	warmhearted	ANT
birth	time	RANDOM
transporter	factory	PART_OF
cherished	precious	SYN
basketry	craft	HYPER
new	roof	RANDOM
ink	forest	RANDOM
belted	unbelted	ANT
lost	saved	ANT
maillot	swimsuit	HYPER
autumnal	vernal	ANT
bathtub	bitch	RANDOM
cellar	freeze	RANDOM
pen	rain	RANDOM
doorknob	building	PART_OF
existence	nonexistence	ANT
wager	pool	PART_OF
illegitimacy	legitimacy	ANT
toenail	pes	PART_OF
audible	inaudible	ANT
disturbing	perturbing	SYN
body	link	RANDOM
ceiling	instrument	RANDOM
comparable	incomparable	ANT
myopic	shortsighted	SYN
groundwork	explanation	PART_OF
sitter	stander	ANT
intractable	tractable	ANT
cud	bit	HYPER
body	right	RANDOM
acetaminophen	medication	HYPER
market	stitch	RANDOM
perfect	cigarette	RANDOM
syllabus	message	HYPER
sleeping	waking	ANT
helix	whorl	SYN
armament	disarmament	ANT
pay	juice	RANDOM
bod	somebody	PART_OF
baseball	move	RANDOM
middling	reasonably	SYN
embellish	pad	SYN
ignorance	dish	RANDOM
first	world-class	SYN
run-up	bowling	PART_OF
geographic	magnetic	ANT
calamus	plumage	PART_OF
fuss	tiff	SYN
plunge	start	HYPER
patriotic	unpatriotic	ANT
adrift	aimless	SYN
bill	expand	RANDOM
hundredweight	quintal	PART_OF
clip	lady	RANDOM
invulnerability	vulnerability	ANT
degeneration	process	HYPER
efficiently	inefficiently	ANT
mobster	principal	HYPER
foregone	gone	SYN
lb	quarter	PART_OF
foreigner	traveller	HYPER
haft	dagger	PART_OF
busy	scissor	RANDOM
flail	flap	HYPER
accidentally	deliberately	ANT
brave	plastic	RANDOM
processor	platform	PART_OF
pale	outside	RANDOM
span	twosome	SYN
ray	re	SYN
multilateral	unilateral	ANT
brew	impregnate	HYPER
laurel	coronal	HYPER
misery	useful	RANDOM
learn	plant	RANDOM
boss	ingredient	RANDOM
blackjack	pressure	SYN
analog	analogue	SYN
runway	transit	PART_OF
imagery	imaging	SYN
trigger	lever	HYPER
man-made	synthetic	SYN
balance	hall	RANDOM
age	lifetime	PART_OF
fence	fencing	SYN
brotherly	sisterly	ANT
oregano	oregano	PART_OF
shelf	buffet	PART_OF
whitener	cause	HYPER
poor	rich	ANT
linear	nonlinear	ANT
credit	debit	ANT
certainty	uncertainty	ANT
hill	event	RANDOM
letter	new	RANDOM
assembly	disassembly	ANT
neckline	sweater	PART_OF
library	manufacture	RANDOM
reported	unreported	ANT
attested	authenticated	SYN
eld	life-time	PART_OF
irritation	soreness	SYN
satisfactory	unsatisfactory	ANT
multiculturalism	nationalism	ANT
oviparous	ovoviviparous	ANT
snobbery	hauteur	HYPER
explicit	implicit	ANT
veil	womb	PART_OF
wainwright	artificer	HYPER
reef	sail	PART_OF
finicky	fussy	SYN
boyfriend	strange	RANDOM
done	through	SYN
deflation	inflation	ANT
hint	tinge	SYN
midnight	nighttime	PART_OF
cent	rand	PART_OF
marriage	flat	RANDOM
orange	open	RANDOM
storyteller	talker	HYPER
suburb	fringe	PART_OF
insecurity	security	ANT
surf	surfboard	SYN
middle	insect	RANDOM
spat	tiff	SYN
liquid	clean	RANDOM
vane	arrow	PART_OF
gauzy	sheer	SYN
sulfur	impact	HYPER
bait	twit	SYN
familial	hereditary	SYN
deadly	pernicious	SYN
chop	mark	RANDOM
dilatory	pokey	SYN
molar	molecular	ANT
easy	uneasy	ANT
manned	unmanned	ANT
australia	hand	RANDOM
facing	sleeve	PART_OF
gibe	jibe	SYN
unwittingly	wittingly	ANT
emptiness	fullness	ANT
bar	oil	RANDOM
amphotericin	antibiotic	HYPER
capability	incapability	ANT
headshot	pic	HYPER
chapter	skyscraper	RANDOM
disrespectfully	respectfully	ANT
magnify	misinform	HYPER
adopted	native	ANT
millimetre	centimetre	PART_OF
reclamation	rescue	HYPER
civility	incivility	ANT
heaving	rising	HYPER
circle	bolt	RANDOM
functioning	malfunctioning	ANT
lederhosen	shorts	HYPER
autonomous	self-reliant	SYN
flagpole	flagstaff	SYN
meth	shabu	SYN
vet	veterinary	SYN
abnormal	normal	ANT
mess	spate	SYN
pestle	battery	PART_OF
mouth	weak	RANDOM
whiskers	homo	PART_OF
pay	fly	RANDOM
backhand	forehand	ANT
conventionally	unconventionally	ANT
brain	up	RANDOM
benefit	wed	RANDOM
emptiness	vacancy	SYN
wonderfully	wondrously	SYN
decision	indecision	ANT
masochist	sadist	ANT
boot	create	RANDOM
litchi	litchi	PART_OF
sphere	region	HYPER
armed	unarmed	ANT
blending	compounding	HYPER
looting	robbery	SYN
undervalue	conceive	HYPER
drinkable	undrinkable	ANT
tailplane	empennage	PART_OF
barf	puke	SYN
lease	cord	RANDOM
dam	jam	HYPER
occupier	dweller	HYPER
alibi	defence	HYPER
pose	vex	SYN
lid	spirit	RANDOM
homeless	stateless	SYN
veg	herb	PART_OF
captain	vertical	RANDOM
frank	excuse	HYPER
subsistence	being	HYPER
crossbar	goalpost	PART_OF
little	commerce	RANDOM
mainframe	platform	PART_OF
gouge	victimize	HYPER
appear	film	RANDOM
chiropractor	expert	HYPER
passing	running	ANT
solidifying	plastination	PART_OF
bollard	wharf	PART_OF
lunch	deceive	RANDOM
bike	sick	RANDOM
birthday	gun	RANDOM
clothing	commodity	HYPER
gross	net	ANT
gravel	pose	SYN
militia	reserves	SYN
sone	phon	PART_OF
nobleman	noblewoman	ANT
roadbed	route	PART_OF
shield	shellfish	PART_OF
nonsmoker	smoker	ANT
goiter	struma	SYN
author	entertainment	RANDOM
rallying	assemblage	HYPER
favourite	preferred	SYN
staircase	edifice	PART_OF
badness	goodness	ANT
paediatrician	medico	HYPER
bisexual	heterosexual	ANT
firth	estuary	HYPER
home	stress	RANDOM
farsighted	nearsighted	ANT
reflect	manifest	HYPER
ordinary	white	RANDOM
fairground	tract	HYPER
sleeping	waking	ANT
boggy	swampy	SYN
impatiently	patiently	ANT
hook	surcharge	SYN
stylus	cartridge	PART_OF
evenly	unevenly	ANT
lowland	upland	ANT
superstar	wiz	SYN
advance	retreat	ANT
ford	stream	PART_OF
tacky	tawdry	SYN
attributive	predicative	ANT
precocious	retarded	ANT
chon	won	PART_OF
beautiful	university	RANDOM
estrogen	oestrogen	SYN
allegiance	fealty	SYN
conformity	nonconformity	ANT
grim	mordant	SYN
shank	watercraft	PART_OF
naive	sophisticated	ANT
stifling	sultry	SYN
chromatic	diatonic	ANT
salt	ready	HYPER
brochure	folder	SYN
double	cards	PART_OF
probable	someone	HYPER
assemble	door	RANDOM
oviparous	viviparous	ANT
yang	yin	ANT
chromatin	nucleus	PART_OF
mushy	soppy	SYN
exposure	photography	HYPER
impressive	unimpressive	ANT
nation	unusual	RANDOM
spur	outfit	HYPER
portion	lucre	PART_OF
so	sol	SYN
blind	sighted	ANT
liquid	post	RANDOM
carom	pool	PART_OF
irritate	impact	HYPER
cuticle	mollusk	PART_OF
calf	post	RANDOM
rail	balustrade	PART_OF
object	constellation	RANDOM
burlesque	charade	SYN
intent	intention	SYN
town	township	SYN
apprehend	savvy	SYN
lingual	linguistic	SYN
evidential	evidentiary	SYN
equipped	unequipped	ANT
revitalize	re-create	HYPER
camber	cant	SYN
cheesecloth	gauze	HYPER
impossibility	possibility	ANT
dribble	drip	SYN
rodent	mammalian	HYPER
51	li	SYN
sully	taint	SYN
blue	ignorance	RANDOM
morph	distort	HYPER
cl	deciliter	PART_OF
lighting	equipment	HYPER
mix	mixing	SYN
switch	alteration	HYPER
japan	extinguish	RANDOM
leader	prosecution	RANDOM
tailfin	decoration	HYPER
gradual	steep	ANT
closing	opening	ANT
successfully	unsuccessfully	ANT
garland	lei	SYN
boo	hoot	SYN
cent	bob	PART_OF
hedge	sidestep	SYN
backside	derriere	SYN
disincentive	incentive	ANT
marriage	mouse	RANDOM
fleet	go	HYPER
disinclination	inclination	ANT
counter	domicile	PART_OF
leak	scissor	RANDOM
jam	wad	SYN
bend	lady	RANDOM
fanatical	overzealous	SYN
diaphragm	camera	PART_OF
impregnate	tincture	SYN
waning	waxing	ANT
substantiate	modify	HYPER
mountain	scissor	RANDOM
arm	munition	PART_OF
objectivity	judgement	HYPER
cannabis	tour	RANDOM
chance	risk	SYN
ocean	hobby	RANDOM
conspirator	principal	HYPER
sinew	musculature	PART_OF
fortissimo	pianissimo	ANT
acid	bitter	SYN
learn	letter	RANDOM
filial	parental	ANT
abort	termination	HYPER
bastard	illegitimate	SYN
accident	end	RANDOM
embody	verbalize	HYPER
maximal	minimal	ANT
formalised	formalized	SYN
urge	rede	HYPER
air-to-air	surface-to-air	ANT
cinque	quintet	SYN
slew	stack	SYN
dryness	wetness	ANT
drunk	drunkard	SYN
liquor	potable	HYPER
gauge	standardize	HYPER
trochanter	femur	PART_OF
collaborator	henchman	SYN
profanation	sacrilege	SYN
field	bowl	PART_OF
dire	horrendous	SYN
muscleman	assailant	HYPER
boiler	steamship	PART_OF
republish	renew	HYPER
conjunctiva	eyelid	PART_OF
benevolence	malevolence	ANT
agreement	rooster	RANDOM
nation	writer	RANDOM
mean	show	RANDOM
clog	jam	HYPER
formed	unformed	ANT
hill	wash	RANDOM
plague	infliction	HYPER
premature	previous	SYN
bookish	studious	SYN
vigor	vigour	SYN
incision	operation	PART_OF
kilo	kilogram	SYN
like	trap	RANDOM
ventricle	caput	PART_OF
high-speed	high-velocity	SYN
jump	stitch	RANDOM
roundabout	route	PART_OF
foursome	quaternary	SYN
cabala	kabala	SYN
mix	live	RANDOM
correctly	incorrectly	ANT
cheap	expensive	ANT
scud	speed	HYPER
new	right	RANDOM
clarity	obscurity	ANT
lease	new	RANDOM
hope	house	RANDOM
favorable	unfavorable	ANT
ration	limit	HYPER
cannabis	misery	RANDOM
centavo	lempira	PART_OF
beastly	hellish	SYN
pint	peck	PART_OF
increase	study	RANDOM
hitch	rub	SYN
snuff	taper	PART_OF
armour	supply	HYPER
distrustful	trustful	ANT
horse	troops	HYPER
customise	customize	SYN
bygone	foregone	SYN
library	line	RANDOM
year	century	PART_OF
tipi	dwelling	HYPER
wintergreen	wintergreen	PART_OF
centromere	nucleus	PART_OF
complimentary	uncomplimentary	ANT
headstone	grave	PART_OF
originator	creator	HYPER
liquor	intoxicant	HYPER
flank	quadruped	PART_OF
corolla	perianth	PART_OF
nonprofessional	professional	ANT
flash	scoot	SYN
chewing	eating	PART_OF
eyepiece	sights	PART_OF
rail	railway	PART_OF
masthead	mast	PART_OF
baby	water	RANDOM
ravage	scourge	SYN
premise	presume	HYPER
hood	flora	PART_OF
bolt	slow	RANDOM
gabled	hipped	ANT
meander	stream	PART_OF
sibilant	fricative	HYPER
reheat	modify	HYPER
believe	conceive	SYN
channel	convey	SYN
cowardly	fearful	SYN
limited	unlimited	ANT
skull	beast	PART_OF
debate	converse	HYPER
saloon	pub	PART_OF
accident	fish	RANDOM
immoral	moral	ANT
stifling	sulfurous	SYN
heterogeneous	homogeneous	ANT
chew	wash	RANDOM
perfect	mouse	RANDOM
irresponsibility	responsibility	ANT
coherent	incoherent	ANT
hole	seal	RANDOM
ovary	angiosperm	PART_OF
repellant	yucky	SYN
conservative	liberal	ANT
forerunner	predecessor	SYN
inescapable	unavoidable	SYN
ischium	thigh	PART_OF
christian	sing	RANDOM
disembarkation	embarkation	ANT
defensively	offensively	ANT
quintal	tonne	PART_OF
consecutive	successive	SYN
activity	inactivity	ANT
appointment	instrumentality	HYPER
township	district	HYPER
learn	bad	RANDOM
key	huge	RANDOM
patsy	sucker	SYN
able	capable	SYN
writing	activity	HYPER
luscious	red-hot	SYN
remedial	therapeutic	SYN
personality	someone	PART_OF
headstone	colonnade	PART_OF
nettlesome	pestering	SYN
impermissible	permissible	ANT
crier	hawker	HYPER
harbor	shield	SYN
horsemeat	horse	PART_OF
appealing	unappealing	ANT
tulle	mesh	HYPER
corner	edifice	PART_OF
angstrom	nanometer	PART_OF
bemusement	mystification	SYN
compose	constitute	HYPER
shearer	workingman	HYPER
insufficiency	sufficiency	ANT
heterodyne	mingle	HYPER
occasion	occurrence	HYPER
foreword	publication	PART_OF
turnaround	route	PART_OF
impressment	appropriation	HYPER
cycle	kilohertz	PART_OF
irregular	regular	ANT
maven	sensation	SYN
button	sweet	RANDOM
fender	engine	PART_OF
key	contaminate	RANDOM
centavo	cordoba	PART_OF
misbehavior	wrongdoing	HYPER
inflammation	kindling	SYN
expiration	respiration	PART_OF
scruff	cervix	PART_OF
triad	aggregation	HYPER
feminine	masculine	ANT
scarce	scarcely	SYN
evaluate	measure	SYN
divination	guess	HYPER
mammal	pull	RANDOM
dig	force	HYPER
assault	onrush	PART_OF
particular	universal	ANT
moll	principal	HYPER
language	pan	RANDOM
condition	process	HYPER
ascendency	dominance	SYN
royalty	payment	HYPER
scrupulous	unscrupulous	ANT
monitor	like	RANDOM
gondola	airship	PART_OF
directly	indirectly	ANT
jog	lie	RANDOM
ban	require	HYPER
dodging	falsity	HYPER
phase	rhythm	PART_OF
engender	spawn	SYN
invisibility	visibility	ANT
carnivorous	herbivorous	ANT
pendent	necklace	PART_OF
capable	incapable	ANT
deceiver	wrongdoer	HYPER
city	material	RANDOM
ampulla	channel	PART_OF
shiver	thrill	SYN
adequacy	inadequacy	ANT
independence	muscle	RANDOM
conservatoire	edifice	HYPER
often	rarely	ANT
afloat	aground	ANT
pawn	assistant	HYPER
gaudy	sporty	SYN
call	slip	RANDOM
championship	title	SYN
aggressor	instigator	HYPER
escutcheon	quarter	PART_OF
unwitting	witting	ANT
bourgeois	conservative	SYN
calamari	squid	PART_OF
incubation	period	HYPER
blemished	unblemished	ANT
veil	uterus	PART_OF
canary	vocalist	HYPER
consumptive	generative	ANT
continuity	discontinuity	ANT
cheat	container	RANDOM
brisk	spanking	SYN
obstructed	unobstructed	ANT
object	goal	RANDOM
withstand	contend	HYPER
slosh	scatter	HYPER
negative	neutral	ANT
proscribed	verboten	SYN
eventful	uneventful	ANT
restricted	unrestricted	ANT
promote	appoint	HYPER
try	probe	HYPER
artwork	publication	PART_OF
hoagie	wedge	SYN
move	floor	RANDOM
caption	version	HYPER
beak	superior	RANDOM
superego	unconscious	PART_OF
intersection	joining	HYPER
acclaim	message	HYPER
demanding	undemanding	ANT
lighten	rejoice	HYPER
orthodox	unorthodox	ANT
biennial	perennial	ANT
learn	feel	RANDOM
confounded	confused	SYN
appreciation	depreciation	ANT
bloom	information	RANDOM
gravitation	levitation	ANT
compliance	noncompliance	ANT
heroism	valour	SYN
new	trash	RANDOM
pubis	pelvis	PART_OF
dishonorable	honorable	ANT
megabit	gigabit	PART_OF
imprecisely	precisely	ANT
cheat	reproduction	RANDOM
restrained	unrestrained	ANT
arm	arms	PART_OF
ceremonially	ritually	SYN
ascending	descending	ANT
pentathlete	contestant	HYPER
boil	lead	RANDOM
crystalline	limpid	SYN
barroom	saloon	PART_OF
favourite	choice	HYPER
perfect	bring	RANDOM
primarily	principally	SYN
meaningful	meaningless	ANT
fidelity	infidelity	ANT
look	transport	RANDOM
merger	combining	HYPER
grate	stove	PART_OF
stockpile	accumulation	HYPER
gallon	bushel	PART_OF
comfortably	uncomfortably	ANT
physique	somebody	PART_OF
organ	detail	RANDOM
pedal	cycle	PART_OF
destiny	supernatural	PART_OF
knot	actor	RANDOM
chela	crustacean	PART_OF
dressing	fertilization	SYN
allocation	apportionment	SYN
conformist	nonconformist	ANT
marrow	os	PART_OF
disconnection	gulf	SYN
saturation	plastination	PART_OF
impartiality	partiality	ANT
protected	unprotected	ANT
forge	progress	HYPER
microsecond	s	PART_OF
unholy	wicked	SYN
beak	city	RANDOM
misfeasance	wrongdoing	HYPER
wanton	dally	HYPER
bather	cause	HYPER
mankind	result	RANDOM
chop	awake	RANDOM
duality	arrangement	HYPER
park	sweet	RANDOM
flimflam	hustle	SYN
athlete	idea	RANDOM
ask	necessitate	SYN
bum	torso	PART_OF
conjugation	junction	SYN
confederacy	conspiracy	SYN
crossing	watercourse	PART_OF
composition	constitution	SYN
panicky	terrified	SYN
unwelcome	welcome	ANT
tiredness	weariness	SYN
basketball	corn	RANDOM
hip	hip	PART_OF
eyelash	optic	PART_OF
mosaic	camera	PART_OF
injure	remove	RANDOM
beef	wagon	RANDOM
aggressiveness	enmity	HYPER
sixties	eld	PART_OF
ligne	in	PART_OF
haft	steel	PART_OF
object	fill	RANDOM
equally	unequally	ANT
neurologist	specialist	HYPER
rotor	blower	PART_OF
plank	platform	PART_OF
affable	amiable	SYN
cornea	optic	PART_OF
midweek	week	PART_OF
blaze	occurrence	HYPER
birth	farm	RANDOM
busy	simple	RANDOM
throttle	aeroplane	PART_OF
hokey	stilted	SYN
crease	flexure	SYN
backing	approval	HYPER
fictitious	pretended	SYN
car	enjoyment	RANDOM
impoverishment	deprivation	HYPER
scores	stacks	SYN
maroon	strand	SYN
prop	setting	PART_OF
entice	invite	HYPER
teen	teenage	SYN
ireland	corn	RANDOM
ease	repose	SYN
jawed	jawless	ANT
majority	minority	ANT
caul	womb	PART_OF
keyboard	jar	RANDOM
efficiency	inefficiency	ANT
replacement	replacing	SYN
masculine	neuter	ANT
minute	lie	RANDOM
loudness	softness	ANT
degenerate	drop	SYN
penis	soul	RANDOM
roman	fount	HYPER
soundless	still	SYN
bike	ignorance	RANDOM
hit	ocean	RANDOM
past	design	RANDOM
sameness	invariance	HYPER
half-century	century	PART_OF
freighter	merchantman	SYN
paisa	rupee	PART_OF
fiber	somebody	PART_OF
grating	stove	PART_OF
icebreaker	watercraft	HYPER
forehead	caput	PART_OF
decline	improvement	ANT
centimetre	meter	PART_OF
ad	advertisement	SYN
bright	mature	RANDOM
decency	indecency	ANT
behind	torso	PART_OF
swirl	vortex	SYN
centralization	decentralization	ANT
competitiveness	aggressiveness	HYPER
sally	undertaking	HYPER
tender	tough	ANT
half-moon	year	PART_OF
sr	sphere	PART_OF
lengthy	prolonged	SYN
moderation	happening	HYPER
add	waterfall	RANDOM
rectify	convert	HYPER
conceit	humility	ANT
hatch	opening	PART_OF
eligible	ineligible	ANT
pinger	sub	PART_OF
cure	treatment	PART_OF
clockwise	counterclockwise	ANT
nadir	zenith	ANT
streaker	someone	HYPER
truncate	truncated	SYN
inquiry	interrogation	SYN
ceramist	thrower	SYN
landing	harbor	PART_OF
creep	fawn	SYN
disgorge	shed	SYN
digression	diversion	SYN
homosexual	one	RANDOM
pectoral	torso	PART_OF
dormancy	ease	HYPER
clitoris	vulva	PART_OF
furlong	league	PART_OF
humility	join	RANDOM
ab	belly	PART_OF
reveille	signaling	HYPER
kid	party	RANDOM
old	fancy	RANDOM
nucleus	point	RANDOM
irrelevance	relevance	ANT
samba	meld	HYPER
conjure	stir	SYN
sphenoid	caput	PART_OF
domineering	submissive	ANT
brave	offspring	RANDOM
impetuous	tearaway	SYN
dingy	grimy	SYN
illegitimately	illicitly	SYN
stabilizer	fuselage	PART_OF
nominative	oblique	ANT
cheek	torso	PART_OF
hamper	bound	HYPER
worth	worthlessness	ANT
pineapple	pineapple	PART_OF
bathroom	increase	RANDOM
accessibility	inaccessibility	ANT
urinate	release	HYPER
aid	want	RANDOM
tensor	variable	HYPER
docent	educator	HYPER
aisle	hate	RANDOM
irresponsible	responsible	ANT
carriageway	expressway	PART_OF
dishonorably	honorably	ANT
doorstep	threshold	PART_OF
pointed	pointless	ANT
kick	forgo	HYPER
high	anticyclone	PART_OF
mankind	enlightenment	RANDOM
brass	authorities	PART_OF
christian	short	RANDOM
cleverness	superiority	HYPER
hospitalization	status	HYPER
clip	time	RANDOM
bulimia	upset	HYPER
lat	torso	PART_OF
percentage	lucre	PART_OF
hockey	make	RANDOM
guess	judge	SYN
monitor	flow	RANDOM
clock	restrict	RANDOM
machine	spread	RANDOM
balance	accounting	PART_OF
vagina	fanny	PART_OF
noise	connect	RANDOM
contracted	expanded	ANT
blooper	flub	SYN
chin	caput	PART_OF
period	era	PART_OF
strength	weakness	ANT
home	perform	RANDOM
japan	stitch	RANDOM
organ	window	RANDOM
fussiness	irritability	SYN
torrent	heap	HYPER
glimpse	aspect	HYPER
rig	semi	SYN
pentacle	pentangle	SYN
spittle	humour	HYPER
hinge	building	PART_OF
discouragement	encouragement	ANT
mineshaft	colliery	PART_OF
beauty	pop	RANDOM
button	size	RANDOM
scape	pillar	PART_OF
cabbage	cabbage	PART_OF
eyelet	drapery	PART_OF
exclusion	inclusion	ANT
lined	unlined	ANT
merciful	merciless	ANT
milk	future	RANDOM
balance	molecule	RANDOM
scalp	transfer	HYPER
fain	gladly	SYN
morgue	edifice	HYPER
debris	rubble	SYN
keystone	colonnade	PART_OF
helianthus	sunflower	SYN
impoverish	deprive	HYPER
belief	strange	RANDOM
answer	hostility	RANDOM
male	zero	RANDOM
imagination	constellation	RANDOM
enchantment	spell	SYN
filament	bulb	PART_OF
folklore	lore	HYPER
pool	stockpile	HYPER
facing	neck	PART_OF
afforestation	conversion	HYPER
hamburger	sandwich	HYPER
peace	tour	RANDOM
cancer	link	RANDOM
toothbrush	moustache	HYPER
mogul	tycoon	SYN
perversion	activity	HYPER
lighted	unlighted	ANT
clement	inclement	ANT
endothermic	exothermic	ANT
obbligato	writing	HYPER
chop	engage	RANDOM
guidance	steering	SYN
airfield	field	SYN
harm	injury	SYN
cranium	skull	PART_OF
sulphur	impact	HYPER
bin	magic	RANDOM
inmate	inpatient	SYN
disproportion	proportion	ANT
petitioner	litigator	HYPER
commode	habitation	PART_OF
optic	homo	PART_OF
optimist	pessimist	ANT
outsmart	outdo	HYPER
ascend	personal	RANDOM
fortunately	unfortunately	ANT
spectator	witness	SYN
eighties	years	PART_OF
lyric	coin	RANDOM
induction	observance	HYPER
hierarchy	authorities	PART_OF
corona	perianth	PART_OF
boredom	evil	RANDOM
subculture	civilisation	PART_OF
arithmetic	constellation	RANDOM
mistake	star	RANDOM
classified	unclassified	ANT
false	true	ANT
glabella	cranium	PART_OF
bungling	clumsy	SYN
blow	win	RANDOM
injury	misadventure	HYPER
three	troika	SYN
night	cat	RANDOM
gondola	dirigible	PART_OF
armature	trolleybus	PART_OF
haggard	worn	SYN
impasse	standstill	SYN
dag	kilogram	PART_OF
stridency	timbre	HYPER
decibel	unit	HYPER
nontechnical	technical	ANT
squabble	tiff	SYN
note	rain	RANDOM
overhand	underhand	ANT
feebleness	frailty	SYN
growling	vocalization	HYPER
cosmonaut	spaceman	SYN
permanently	temporarily	ANT
join	shoe	RANDOM
corolla	blossom	PART_OF
muskrat	rodent	HYPER
challenging	intriguing	SYN
clean	disgust	RANDOM
hindquarters	quadruped	PART_OF
straggler	layabout	HYPER
zodiac	diagram	HYPER
kb	gigabit	PART_OF
bankrupt	nonstarter	HYPER
circulation	dissemination	HYPER
illogical	logical	ANT
lyric	room	RANDOM
misanthrope	grump	HYPER
trustworthy	untrustworthy	ANT
fingered	fingerless	ANT
voicing	registration	HYPER
fussy	particular	SYN
pilus	mammalian	PART_OF
rat	cushioning	HYPER
pes	homo	PART_OF
consecrate	declare	HYPER
draftsman	artist	HYPER
decontamination	removal	HYPER
compatriot	subject	HYPER
clean	ideology	RANDOM
beckon	interact	HYPER
apparent	evident	SYN
rye	rye	PART_OF
mississippi	sound	RANDOM
masochistic	sadistic	ANT
ceiling	satisfy	RANDOM
breech	barrel	PART_OF
creditor	debtor	ANT
forty-six	xlvi	SYN
sandwich	repast	PART_OF
branch	fabric	RANDOM
mite	speck	SYN
meaning	thought	HYPER
resultant	variable	HYPER
overly	too	SYN
jab	poke	SYN
exaltation	sphere	PART_OF
section	surgery	PART_OF
consistency	inconsistency	ANT
concordant	consonant	SYN
emulate	imitate	HYPER
orbit	extent	HYPER
lobby	clean	RANDOM
mannerly	well-mannered	SYN
bazaar	fair	SYN
sitter	biddy	HYPER
maxwell	weber	PART_OF
chou	vegetable	HYPER
rag	tease	SYN
sunroof	auto	PART_OF
care	appear	RANDOM
wrestle	consider	HYPER
endorse	authorize	HYPER
dock	seaport	PART_OF
depressant	stimulative	ANT
shrimp	shrimp	PART_OF
quintal	kiloton	PART_OF
body	history	RANDOM
style	blossom	PART_OF
loth	reluctant	SYN
ascend	west	RANDOM
hock	ungulate	PART_OF
fleet	speed	HYPER
gradual	sudden	ANT
gargle	happening	HYPER
disenfranchised	enfranchised	ANT
tuna	tunny	PART_OF
waterside	bank	HYPER
recombine	modify	HYPER
emotional	unemotional	ANT
clairvoyant	precognitive	SYN
roofed	roofless	ANT
hospitable	inhospitable	ANT
ocean	prosecution	RANDOM
attentive	inattentive	ANT
camp	assemblage	HYPER
bit	hear	RANDOM
chutzpah	impudence	HYPER
personify	impute	HYPER
recoup	withhold	SYN
change	taste	RANDOM
medium	environs	HYPER
house	moon	RANDOM
attraction	repulsion	ANT
pass	weed	RANDOM
nucleus	girlfriend	RANDOM
china	cord	RANDOM
flout	discount	HYPER
tug	actuation	HYPER
withdraw	cease	HYPER
whirlpool	current	HYPER
library	planet	RANDOM
honesty	end	RANDOM
conveyer	factory	PART_OF
general	specific	ANT
contraction	expansion	ANT
candelabra	holder	HYPER
middle	toe	RANDOM
mouse	strip	RANDOM
feces	excretion	HYPER
harvesting	aggregation	HYPER
yolk	eggs	PART_OF
part	sea	RANDOM
animal	generous	RANDOM
teepee	lodge	HYPER
surge	tide	SYN
staircase	building	PART_OF
virtuous	wicked	ANT
safeguard	escort	HYPER
precis	repeat	HYPER
mickle	raft	SYN
bill	justice	RANDOM
vulcanology	geophysics	HYPER
creditor	debtor	ANT
diaper	garment	HYPER
examination	testing	SYN
dogfight	engagement	HYPER
herpetologist	zoologist	HYPER
apogee	perigee	ANT
lunch	communication	RANDOM
mi	mile	SYN
yarn	recite	HYPER
indexing	grouping	HYPER
tarragon	tarragon	PART_OF
kind	suck	RANDOM
shillelagh	cudgel	HYPER
house	unknown	RANDOM
murder	test	RANDOM
chairman	chairwoman	SYN
gnarled	gnarly	SYN
jaw	homo	PART_OF
lazy	bring	RANDOM
humane	inhumane	ANT
dispute	disagreement	HYPER
finder	gunsight	PART_OF
capstone	building	PART_OF
beef	enlightenment	RANDOM
withers	ox	PART_OF
cucumber	cucumber	PART_OF
veto	choice	HYPER
postcode	destination	PART_OF
hayloft	mow	SYN
sympathetic	unsympathetic	ANT
bridle	confine	HYPER
cushion	layer	HYPER
endemic	epidemic	ANT
mate	see	RANDOM
indemnity	restitution	SYN
endometrium	womb	PART_OF
lowercase	uppercase	ANT
professional	unprofessional	ANT
confer	utter	HYPER
thud	thump	SYN
neve	glacier	PART_OF
letter	dislike	RANDOM
action	hem	RANDOM
happily	unhappily	ANT
appropriateness	inappropriateness	ANT
thinking	thought	SYN
impoundment	internment	SYN
clump	occurrence	HYPER
genesis	happening	HYPER
readership	audience	HYPER
radius	cart	PART_OF
concentration	dilution	ANT
bereaved	bereft	SYN
tend	assist	HYPER
slick	wily	SYN
chicha	shisha	SYN
chain	slip	RANDOM
thorough	thoroughgoing	SYN
delve	dig	SYN
life	table	RANDOM
often	oftentimes	SYN
mountainside	mount	PART_OF
bloom	lobby	RANDOM
black	landscape	RANDOM
madden	rag	HYPER
intimidate	arouse	HYPER
malleus	tympanum	PART_OF
questionable	unquestionable	ANT
belief	interest	RANDOM
congeniality	friendliness	HYPER
bloom	trade	RANDOM
pillbox	toque	SYN
shaft	pointer	PART_OF
aspiration	respiration	PART_OF
do	terminate	HYPER
grad	grade	SYN
semitrailer	rig	PART_OF
allure	ask	HYPER
mythology	aggregation	HYPER
can	abode	PART_OF
sixty-fourth	fraction	HYPER
image	sword	RANDOM
seasonal	year-round	ANT
durian	durian	PART_OF
conveyor	mill	PART_OF
admire	book	RANDOM
ruck	crease	HYPER
bullfighter	toreador	SYN
varmint	someone	HYPER
inflow	outflow	ANT
incline	elevation	PART_OF
joust	tournament	PART_OF
carat	gm	PART_OF
actor	hem	RANDOM
penis	horn	RANDOM
scoop	dredge	PART_OF
breastbone	torso	PART_OF
maneuver	manoeuvre	SYN
discernible	indiscernible	ANT
orthopaedics	orthopedics	SYN
micron	cm	PART_OF
dead	living	ANT
artillery	battery	PART_OF
approach	eyeglass	RANDOM
quoin	building	PART_OF
arteriosclerosis	pathology	HYPER
pressure	actuation	HYPER
air	cap	RANDOM
lower-class	middle-class	ANT
wakefulness	watchfulness	SYN
bone	shadow	RANDOM
precede	go	HYPER
generosity	stinginess	ANT
cumbersome	inept	SYN
nonresidential	residential	ANT
multi-colored	multicoloured	SYN
organization	authorities	PART_OF
hostess	innkeeper	HYPER
paint	part	RANDOM
mm	centimetre	PART_OF
curtail	trim	HYPER
desiccation	plastination	PART_OF
scramble	go	HYPER
tempestuous	wild	SYN
box	busy	RANDOM
masochist	sadist	ANT
definite	indefinite	ANT
predictor	flak	PART_OF
garnish	beautify	HYPER
marjoram	oregano	PART_OF
affection	ideology	RANDOM
least	most	ANT
crucify	devil	HYPER
minor	tyke	SYN
gravestone	grave	PART_OF
debonair	jaunty	SYN
deflate	trim	HYPER
turtleneck	jumper	HYPER
heaviness	lightness	ANT
reel	spin	SYN
bewitching	enthralling	SYN
censure	criticize	HYPER
majority	adulthood	PART_OF
adulterous	extramarital	SYN
bearing	heraldry	HYPER
drift	heading	SYN
barker	pooch	SYN
compensated	stipendiary	SYN
extend	affect	HYPER
atrocity	barbarity	SYN
sail	sweep	SYN
lose	document	RANDOM
tomorrow	hereafter	HYPER
destructible	indestructible	ANT
sauropod	dinosaur	HYPER
giblets	fowl	PART_OF
nice	rank	RANDOM
inequitable	unjust	SYN
massif	range	PART_OF
move	father	RANDOM
shelf	sideboard	PART_OF
tortilla	wrap	PART_OF
homework	teaching	PART_OF
anaesthetic	anesthetic	SYN
ft	lea	PART_OF
dishonestly	honestly	ANT
almighty	omnipotent	SYN
pectoral	thorax	PART_OF
shank	racquet	PART_OF
valve	pump	PART_OF
minute	goal	RANDOM
circumstance	setting	SYN
card	cardboard	HYPER
destination	correspondence	PART_OF
anode	cathode	ANT
educationalist	educationist	SYN
rut	imprint	HYPER
substructure	structure	PART_OF
intent	significance	HYPER
rotor	smoother	PART_OF
hew	mould	HYPER
bellowing	outcry	HYPER
defeated	undefeated	ANT
melamine	alkali	HYPER
collision	disagreement	HYPER
tactful	tactless	ANT
prompter	supporter	HYPER
crowfoot	herb	HYPER
bushel	cwt	PART_OF
boot	fireplace	RANDOM
hillside	hill	PART_OF
lawful	licit	SYN
list	tilt	HYPER
con	pro	ANT
cps	kc	PART_OF
eardrum	caput	PART_OF
elevation	height	SYN
signature	manner	HYPER
misery	step	RANDOM
pass	unknown	RANDOM
stapes	tympanum	PART_OF
functional	useable	SYN
debris	junk	SYN
breast	vertebrate	PART_OF
steering	seafaring	PART_OF
braincase	bone	HYPER
dip	inclination	SYN
cusp	pump	PART_OF
anti	pro	ANT
handover	relinquishment	HYPER
bumble	stumble	SYN
jack	bowls	PART_OF
male	lot	RANDOM
tweed	white	SYN
bind	tv	RANDOM
hope	desire	HYPER
command	overlook	SYN
congresswoman	lawmaker	HYPER
multitudinous	unnumbered	SYN
anterior	posterior	ANT
inorganic	organic	ANT
sonic	subsonic	ANT
australia	wife	RANDOM
cellar	wash	RANDOM
placenta	bloom	PART_OF
nonconformist	recusant	SYN
jet	course	HYPER
pica	ft	PART_OF
administration	regime	PART_OF
defence	offence	ANT
grosz	zloty	PART_OF
promenade	troop	SYN
thole	dory	PART_OF
lower-class	upper-class	ANT
hop	think	RANDOM
plum	plum	PART_OF
fingernail	manus	PART_OF
sibling	relation	HYPER
domestic	foreign	ANT
meat	stage	RANDOM
cochlea	labyrinth	PART_OF
twenties	maturity	PART_OF
efflorescence	inflorescence	SYN
decipher	decrypt	SYN
insignificance	significance	ANT
decrement	increment	ANT
meat	scissor	RANDOM
amygdala	pallium	PART_OF
seesaw	artefact	HYPER
forearm	homo	PART_OF
pallidum	striatum	PART_OF
pier	edifice	PART_OF
bogey	aircraft	HYPER
manioc	gari	PART_OF
seamless	unlined	SYN
bone	pierce	RANDOM
eyebrow	caput	PART_OF
dendrite	neuron	PART_OF
hockey	fix	RANDOM
needed	required	SYN
religious	secular	ANT
pretence	dissembling	HYPER
apprehension	getting	HYPER
morning	tan	RANDOM
institutionalised	institutionalized	SYN
party	jacket	RANDOM
fleet	airway	PART_OF
luckily	unluckily	ANT
barker	promoter	HYPER
covenant	declare	HYPER
neck	tool	RANDOM
diaphragm	preventive	HYPER
cut-up	hoaxer	SYN
traceable	untraceable	ANT
association	disassociation	ANT
reorganize	command	HYPER
speciality	specialness	SYN
innocuous	noxious	ANT
news	skin	RANDOM
clarity	opacity	ANT
shipwreck	forestall	HYPER
tug	tow	HYPER
clasp	bangle	PART_OF
style	pistil	PART_OF
tithe	transfer	HYPER
line	laugh	RANDOM
middle	tail	RANDOM
birthday	shop	RANDOM
loud	sadness	RANDOM
jobber	middleman	SYN
knot	plank	PART_OF
excise	scratch	SYN
odorless	odorous	ANT
boil	separation	RANDOM
suburbia	outskirt	PART_OF
corncob	maize	PART_OF
wish	utter	HYPER
windscreen	aeroplane	PART_OF
electrode	tube	PART_OF
nice	science	RANDOM
clown	joke	HYPER
pressurize	supercharge	SYN
beauty	brush	RANDOM
offender	wrongdoer	SYN
breast	reach	HYPER
minister	stale	RANDOM
catching	deed	HYPER
name	itemize	HYPER
gazetteer	atlas	PART_OF
encroach	progress	HYPER
multitudinous	myriad	SYN
factor	lend	HYPER
celebration	jubilation	SYN
lobby	human	RANDOM
orchestra	theater	PART_OF
battle	mail	RANDOM
pedal	prosecution	RANDOM
abundant	scarce	ANT
cheat	letter	RANDOM
thickness	thinness	ANT
mythic	mythical	SYN
benign	malignant	ANT
lady	tool	RANDOM
parent	perfect	RANDOM
buttery	eatery	HYPER
mississippi	save	RANDOM
adult	seal	RANDOM
manioc	manioc	PART_OF
diaphanous	transparent	SYN
gem	jewellery	PART_OF
goading	commendation	HYPER
plight	assure	HYPER
grapefruit	citrus	HYPER
luncheon	tiffin	SYN
bats	haywire	SYN
everyday	quotidian	SYN
insurer	underwriter	SYN
shackle	padlock	PART_OF
frugality	discretion	HYPER
twinkle	vigor	HYPER
language	challenge	RANDOM
implosion	plosive	PART_OF
casing	building	PART_OF
chartered	unchartered	ANT
bronzed	suntanned	SYN
autumnal	summery	ANT
eighties	age	PART_OF
microsecond	millisecond	PART_OF
ligne	ft	PART_OF
case	mammal	RANDOM
brokerage	concern	HYPER
burn	wind	RANDOM
peace	hold	RANDOM
pyrrhic	measure	HYPER
beach	happy	RANDOM
ending	recital	PART_OF
little	nature	RANDOM
broccoli	broccoli	PART_OF
belt	roof	RANDOM
endear	gratify	HYPER
contrary	relation	HYPER
arithmetic	weapon	RANDOM
deductible	nondeductible	ANT
crossbreeding	hybridizing	SYN
malnourished	nourished	ANT
puberty	adolescence	PART_OF
continuance	discontinuance	ANT
paid	unpaid	ANT
cajole	palaver	SYN
allele	factor	HYPER
basement	less	RANDOM
hush	lave	HYPER
urethra	phallus	PART_OF
nucleus	pleasure	RANDOM
fame	infamy	ANT
earthly	heavenly	ANT
responsibility	fibre	PART_OF
storage	platform	PART_OF
metacarpal	mitt	PART_OF
amphipod	crustacean	HYPER
gap	location	HYPER
hodgepodge	melange	SYN
external	internal	ANT
nephew	niece	ANT
lots	scads	SYN
hockey	illness	RANDOM
least	most	ANT
estragon	estragon	PART_OF
dam	kilometre	PART_OF
faithfulness	fidelity	SYN
fade	slicing	SYN
movie	care	RANDOM
tedious	wearisome	SYN
suspension	railcar	PART_OF
edging	textile	PART_OF
high	stitch	RANDOM
slap	slapdash	SYN
profundity	superficiality	ANT
bathtub	cave	RANDOM
quince	quince	PART_OF
misused	used	ANT
peg	dinghy	PART_OF
domino	masquerade	PART_OF
slipknot	riata	PART_OF
raja	patrician	HYPER
susceptibility	condition	HYPER
egress	ingress	ANT
bob	pendulum	PART_OF
unpredictability	uncertainty	HYPER
impala	antelope	HYPER
better	worse	ANT
asker	talker	HYPER
followup	production	HYPER
inch	ft	PART_OF
movement	criminal	RANDOM
artificially	naturally	ANT
foolishly	wisely	ANT
mutagenesis	mutation	PART_OF
penetration	entering	HYPER
ray	fin	PART_OF
diluted	undiluted	ANT
boundless	limitless	SYN
conveyer	mill	PART_OF
left-handed	right-handed	ANT
pound	cental	PART_OF
aurora	sunrise	SYN
blood	equal	RANDOM
expiration	ventilation	PART_OF
rat	coiffure	PART_OF
bathtub	surface	RANDOM
steadiness	unsteadiness	ANT
loudness	softness	ANT
fudge	manipulate	SYN
hometown	town	HYPER
level	wrong	RANDOM
lid	pick	RANDOM
pincushion	padding	HYPER
language	woman	RANDOM
20	twenty	SYN
dystopia	utopia	ANT
lamella	bone	PART_OF
squid	squid	PART_OF
yell	utter	HYPER
eastern	western	ANT
disproportionately	proportionately	ANT
house	plot	RANDOM
aware	unaware	ANT
dissimilar	similar	ANT
spermatogenesis	growing	HYPER
horseman	rider	HYPER
venation	foliage	PART_OF
bed	develop	RANDOM
runway	track	SYN
parish	episcopate	PART_OF
high-tech	low-tech	ANT
inherited	transmitted	SYN
recurring	revenant	SYN
interpreter	translator	SYN
illiteracy	literacy	ANT
cosmopolitan	provincial	ANT
pufferfish	pufferfish	PART_OF
history	thin	RANDOM
segmentation	pregnancy	PART_OF
disequilibrium	equilibrium	ANT
decision	determination	SYN
lean	tip	SYN
suitability	unsuitability	ANT
aimless	floating	SYN
mean	south	RANDOM
conveyer	manufactory	PART_OF
dg	gm	PART_OF
barring	expulsion	HYPER
clasp	purse	PART_OF
veal	calf	PART_OF
perianth	angiosperm	PART_OF
implantation	locating	HYPER
goose	twinge	HYPER
boredom	mystery	RANDOM
jail	health	RANDOM
raspberry	razz	SYN
low	clothe	RANDOM
basketball	element	RANDOM
singularity	uniqueness	SYN
forgive	grant	HYPER
knot	residence	RANDOM
optimistically	pessimistically	ANT
organize	unionize	SYN
hadj	hajj	SYN
impress	print	SYN
vote	voting	SYN
brightness	luminosity	SYN
cheap	gaudy	SYN
rhyme	rime	SYN
berry	berry	PART_OF
air	run	RANDOM
askew	wonky	SYN
grammatical	ungrammatical	ANT
unventilated	ventilated	ANT
coldness	hotness	ANT
capitalism	socialism	ANT
airbrush	spray	HYPER
maudlin	schmaltzy	SYN
acutely	astutely	SYN
bipedal	quadrupedal	ANT
intensifying	moderating	ANT
presbytery	church	PART_OF
surpass	go	HYPER
bail	system	HYPER
behemoth	colossus	SYN
cervix	uterus	PART_OF
humorless	humorous	ANT
evocation	dispossession	PART_OF
pinger	asdic	PART_OF
movement	pleasure	RANDOM
downward	upward	ANT
meantime	interval	HYPER
closet	experiment	RANDOM
cubic	linear	ANT
dedicate	determine	HYPER
swede	rutabaga	PART_OF
bird	steal	RANDOM
boat	organ	RANDOM
leafless	leafy	ANT
hallucination	thought	HYPER
projection	prediction	HYPER
main	primary	SYN
black	blackened	SYN
tender	tippy	SYN
case	somebody	HYPER
schoolhouse	edifice	HYPER
miscellany	smorgasbord	SYN
uniting	consolidation	HYPER
marvellous	rattling	SYN
flash	trice	SYN
pass	curve	RANDOM
bouncy	zippy	SYN
marriage	narrow	RANDOM
centavo	boliviano	PART_OF
gimel	grapheme	HYPER
catastrophe	disaster	SYN
eyelet	curtain	PART_OF
leave	organism	RANDOM
dominate	eclipse	SYN
bill	peach	RANDOM
past	complex	RANDOM
parasailing	flying	HYPER
peristome	invertebrate	PART_OF
scan	search	HYPER
octopus	octopus	PART_OF
pink	rap	SYN
add	hero	RANDOM
manufacture	quiet	RANDOM
aisle	expand	RANDOM
jewellery	jewelry	SYN
pedal	unique	RANDOM
block	disrupt	HYPER
alive	dead	ANT
maidenhead	vagina	PART_OF
hindrance	interference	SYN
america	stale	RANDOM
front	battlefield	PART_OF
insignificant	significant	ANT
blessed	cursed	ANT
labour	maternity	PART_OF
phase	cycle	PART_OF
heaps	lashings	SYN
attractor	someone	HYPER
broaden	widen	SYN
poking	thrusting	SYN
rounders	ballgame	HYPER
approach	interest	RANDOM
relict	being	HYPER
labor	needle	RANDOM
quart	gallon	PART_OF
lease	jar	RANDOM
chaw	cud	SYN
lie	retire	RANDOM
chocolate	stage	RANDOM
caucus	interact	HYPER
knot	strip	RANDOM
heirloom	belongings	HYPER
basketball	justice	RANDOM
horn	seal	RANDOM
headstone	aqueduct	PART_OF
backpacker	hiker	HYPER
gumbo	okra	PART_OF
anchorage	harbor	PART_OF
hop	unique	RANDOM
crowded	uncrowded	ANT
analysis	synthesis	ANT
painfully	painlessly	ANT
assembly	disassembly	ANT
formality	informality	ANT
japan	weed	RANDOM
carom	motion	HYPER
planetarium	planetarium	PART_OF
disembarkation	embarkation	ANT
matter	reverse	RANDOM
realm	domain	HYPER
nation	rise	RANDOM
bannister	balcony	PART_OF
gunstock	pistol	PART_OF
obeisance	reverence	HYPER
cackle	chatter	SYN
jib	resist	SYN
second	hr	PART_OF
superiority	domination	HYPER
responsibility	fiber	PART_OF
minuscule	grapheme	HYPER
pain	satisfaction	RANDOM
organized	unionised	SYN
devolution	evolution	ANT
nauseating	nauseous	SYN
meshing	network	SYN
heave	utter	HYPER
immature	unripe	SYN
illiterate	literate	ANT
salinity	saltiness	SYN
midsummer	summer	PART_OF
pale	pillow	RANDOM
deposit	put	HYPER
interesting	uninteresting	ANT
chop	liquid	RANDOM
forthcoming	outgoing	SYN
bitingly	piercingly	SYN
chili	chilli	SYN
episcopate	territory	HYPER
running	standing	ANT
personality	somebody	PART_OF
exponent	proponent	SYN
infuriating	maddening	SYN
soya	soy	PART_OF
jog	break	RANDOM
puff	smoking	PART_OF
fibre	somebody	PART_OF
apron	field	PART_OF
floodgate	sluice	PART_OF
mollusc	shellfish	SYN
release	transmit	HYPER
adage	saying	HYPER
parlor	domicile	PART_OF
humility	keyboard	RANDOM
nineties	years	PART_OF
accurately	inaccurately	ANT
offspring	beat	RANDOM
nape	cervix	PART_OF
adapter	transcriber	SYN
balance	pot	RANDOM
leaflet	pump	PART_OF
human	order	RANDOM
inwardly	outwardly	ANT
ordinary	shape	RANDOM
puzzle	speculate	HYPER
gutless	gutsy	ANT
breast	view	RANDOM
bird	stress	RANDOM
chatter	conversation	HYPER
ashamed	unashamed	ANT
imperfection	perfection	ANT
muzzle	fauna	PART_OF
fold	incorporate	HYPER
presidium	commission	HYPER
treadle	cycle	PART_OF
miro	conifer	HYPER
go	harmonise	HYPER
grace	behaviour	HYPER
flattop	hairdo	HYPER
generalist	specialist	ANT
aperture	telescope	PART_OF
spearhead	lance	PART_OF
eligibility	ineligibility	ANT
leaf	keep	RANDOM
okra	gumbo	PART_OF
matrix	digit	PART_OF
clip	cultivate	RANDOM
infrastructure	system	PART_OF
modeler	somebody	HYPER
inner	outer	ANT
exploited	unexploited	ANT
strap	luggage	PART_OF
pollard	clip	HYPER
convergence	divergence	ANT
bow	watercraft	PART_OF
hanky	textile	HYPER
peck	quarter	PART_OF
sleepiness	wakefulness	ANT
migrant	migratory	SYN
mouthful	serving	PART_OF
frying	sauteing	SYN
pander	wrongdoer	HYPER
fast	desist	HYPER
chicken	tan	RANDOM
patrolman	defender	HYPER
downwind	upwind	ANT
bright	soft	RANDOM
ginseng	ginseng	PART_OF
judge	prosecution	RANDOM
insolvency	solvency	ANT
acknowledged	unacknowledged	ANT
penis	nasty	RANDOM
burst	fit	SYN
oxygen	house	RANDOM
mississippi	slow	RANDOM
morn	daylight	PART_OF
gimpy	halt	SYN
inpatient	outpatient	ANT
decimate	eliminate	SYN
ability	inability	ANT
impassable	passable	ANT
nephew	niece	ANT
bait	rally	SYN
chile	jalapeno	PART_OF
aflame	aroused	SYN
mississippi	come	RANDOM
clean	please	RANDOM
morello	morello	PART_OF
bathtub	chain	RANDOM
mouse	kindness	RANDOM
chip	unhappiness	RANDOM
blast	displace	HYPER
pain	literature	RANDOM
kick	kvetch	SYN
vane	plumage	PART_OF
doable	manageable	SYN
disorienting	orienting	ANT
anger	letter	RANDOM
beef	mystery	RANDOM
tumble	lessen	HYPER
decent	indecent	ANT
jowl	caput	PART_OF
arrest	pinch	SYN
malleable	tensile	SYN
damages	redress	SYN
restful	restless	ANT
defence	offence	ANT
equatorial	polar	ANT
ping	pink	SYN
en	em	PART_OF
kitschy	maudlin	SYN
apportioning	parceling	SYN
idle	manufacture	RANDOM
clavier	piano	PART_OF
ascendant	condition	HYPER
diversity	variety	SYN
candy	cord	RANDOM
collusive	conniving	SYN
skeptic	intellectual	HYPER
candy	cup	RANDOM
signification	message	HYPER
lunch	red	RANDOM
atmosphere	fill	RANDOM
mouse	umbrella	RANDOM
bankruptcy	proceeding	HYPER
calf	leaf	RANDOM
brave	highway	RANDOM
comedy	tragedy	ANT
chocolate	neutron	RANDOM
thrill	excite	HYPER
handrail	balcony	PART_OF
afterburner	turbofan	PART_OF
burn	eyeglass	RANDOM
rotor	ignition	PART_OF
hindquarters	torso	PART_OF
grunt	oink	SYN
pastor	reverend	HYPER
mesh	snatch	HYPER
sanitary	unsanitary	ANT
stamen	bloom	PART_OF
landed	landless	ANT
belt	utter	HYPER
candy	word	RANDOM
relatedness	connexion	HYPER
falter	faltering	SYN
deformed	misshapen	SYN
adjoin	border	SYN
substrate	component	HYPER
thumbnail	thumb	PART_OF
qualify	fulfil	HYPER
insubordinate	subordinate	ANT
exhibition	grouping	HYPER
disfavour	identify	HYPER
hill	window	RANDOM
bow	gown	RANDOM
animal	service	RANDOM
sleeve	garment	PART_OF
disingenuous	ingenuous	ANT
pecker	shaft	SYN
helm	powerboat	PART_OF
belt	hobby	RANDOM
learn	pillow	RANDOM
commonality	individuality	ANT
brighten	modify	HYPER
defeated	discomfited	SYN
banknote	greenback	SYN
burn	snow	RANDOM
ball	student	RANDOM
mistake	cool	RANDOM
kissing	foreplay	HYPER
augmentation	diminution	ANT
docile	stubborn	ANT
glop	mush	SYN
antagonistic	synergistic	ANT
floodgate	restraint	HYPER
sweatpants	sweatsuit	PART_OF
layer	laminate	PART_OF
cannabis	win	RANDOM
cabin	spacecraft	PART_OF
keyboard	think	RANDOM
first	auto	PART_OF
clarity	obscurity	ANT
ridicule	mock	HYPER
top-flight	topping	SYN
courteous	discourteous	ANT
kisser	homo	PART_OF
market	scale	RANDOM
dysphoria	euphoria	ANT
amphibious	terrestrial	ANT
decline	improvement	ANT
millennium	ism	HYPER
blade	watch	RANDOM
4	digit	HYPER
publication	product	HYPER
downstream	upstream	ANT
check	retard	SYN
spineless	spinous	ANT
changeable	mutable	SYN
oblique	parallel	ANT
level	statue	RANDOM
plough	transmute	HYPER
disperse	inform	HYPER
deny	disown	HYPER
sixties	years	PART_OF
paltry	trifling	SYN
farsightedness	presbyopia	SYN
drawer	buffet	PART_OF
birth	they	RANDOM
sphenoid	skull	PART_OF
clasp	bag	PART_OF
wheeler	artisan	HYPER
snippet	snipping	SYN
shelter	put	HYPER
lower	desert	RANDOM
labor	pregnancy	PART_OF
forward	onwards	SYN
bedroom	idle	RANDOM
chip	fleck	SYN
old	good	RANDOM
blanch	blench	SYN
hunt	divert	HYPER
caput	fauna	PART_OF
centavo	quetzal	PART_OF
boldness	timidity	ANT
disorganisation	disturbance	HYPER
bin	valuable	RANDOM
chomp	feeding	HYPER
ivory	tusk	SYN
patella	knee	PART_OF
crucify	gravel	HYPER
dishonour	shame	SYN
ruckus	tumult	SYN
keystone	arch	PART_OF
hurt	zero	RANDOM
dullness	sharpness	ANT
hasten	hurry	SYN
satsuma	satsuma	PART_OF
externally	internally	ANT
naturist	somebody	HYPER
expansive	grand	SYN
organ	cloud	RANDOM
pen	square	RANDOM
pass	confuse	RANDOM
cc	mil	SYN
buss	kiss	SYN
like	house	RANDOM
eligibility	ineligibility	ANT
improbability	probability	ANT
basketball	coin	RANDOM
prognosis	diagnosis	HYPER
nutmeg	nutmeg	PART_OF
crush	oppress	SYN
limb	bow	PART_OF
new	paper	RANDOM
incorporated	integrated	SYN
following	leading	ANT
downstage	theatre	PART_OF
medicine	soft	RANDOM
compassion	mercy	HYPER
harmonize	fit	HYPER
outcome	upshot	SYN
calyx	whorl	HYPER
deflationary	inflationary	ANT
hazard	jeopardy	SYN
loosening	tightening	ANT
shy	startle	HYPER
marriage	shop	RANDOM
lightheadedness	symptom	HYPER
undecided	unresolved	SYN
chestnut	chestnut	PART_OF
cushion	suspension	PART_OF
track	railroad	PART_OF
indebtedness	liability	SYN
beach	test	RANDOM
learn	ram	RANDOM
milk	strong	RANDOM
beard	goat	PART_OF
pharynx	cervix	PART_OF
facultative	obligate	ANT
carry	know	RANDOM
capsule	dose	HYPER
beatific	saintly	SYN
iron	nice	RANDOM
embargo	disallow	HYPER
fleet	airline	PART_OF
matter	dance	RANDOM
finagle	wangle	SYN
collective	distributive	ANT
central	peripheral	ANT
shutter	camera	PART_OF
high	telephone	RANDOM
strap	teddy	PART_OF
scouring	cleaning	HYPER
diplomatic	undiplomatic	ANT
compressible	incompressible	ANT
goodness	attribute	HYPER
wolverine	carnivore	HYPER
sanction	empowerment	HYPER
capillary	thermometer	PART_OF
mil	deciliter	PART_OF
strain	utilise	HYPER
aft	fore	ANT
morning	side	RANDOM
rib	watercraft	PART_OF
extrovert	introvert	ANT
climb	student	RANDOM
benevolence	malevolence	ANT
facial	homo	PART_OF
mow	barn	PART_OF
centimeter	meter	PART_OF
wainwright	journeyman	HYPER
cheat	rig	SYN
humility	picture	RANDOM
pier	span	PART_OF
convent	sect	PART_OF
gutter	sewer	SYN
barrack	stir	HYPER
fingerboard	accordion	PART_OF
consummated	unconsummated	ANT
ascomycete	being	HYPER
tombstone	tomb	PART_OF
educator	pedagogue	SYN
asdic	sonar	SYN
plait	distort	HYPER
mammal	space	RANDOM
lucid	transparent	SYN
endless	interminable	SYN
ethically	unethically	ANT
ardour	elan	SYN
rap	tap	SYN
close	yard	RANDOM
downstream	upstream	ANT
succession	ordering	HYPER
dock	harbor	PART_OF
nightmare	dreaming	HYPER
puffer	puffer	PART_OF
ng	mg	PART_OF
blue	manufacture	RANDOM
insanity	sanity	ANT
constructive	destructive	ANT
installment	series	PART_OF
start	starting	SYN
boil	gang	RANDOM
dissolution	profligacy	SYN
chilly	jalapeno	PART_OF
cheat	chicane	SYN
antagonize	rag	HYPER
finder	scope	PART_OF
confinement	maternity	PART_OF
bettering	worsening	ANT
neck	huge	RANDOM
rebuff	reject	HYPER
skid	skid	HYPER
alike	similar	SYN
ferocious	savage	SYN
doomsday	happening	HYPER
inhalation	respiration	PART_OF
indoors	outdoors	ANT
pilot	seafarer	HYPER
exclusion	inclusion	ANT
astronomic	astronomical	SYN
dominate	overshadow	SYN
gab	schmooze	HYPER
locator	engineer	HYPER
boot	free	RANDOM
ignorance	fabric	RANDOM
fragrant	malodorous	ANT
become	beautify	HYPER
decelerate	retard	SYN
white	discolor	HYPER
harpoon	clutch	HYPER
parts	surround	HYPER
easterly	westerly	ANT
author	unhappy	RANDOM
creeper	someone	HYPER
vibes	vibraphone	SYN
cough	symptom	HYPER
injure	tank	RANDOM
poppet	powerboat	PART_OF
collage	accumulation	HYPER
insert	utter	HYPER
hope	get	RANDOM
countenance	homo	PART_OF
boat	growth	RANDOM
wavelength	attitude	HYPER
aisle	standard	RANDOM
prologue	theater	PART_OF
hardship	fate	HYPER
arena	field	HYPER
centavo	austral	PART_OF
nastiness	niceness	ANT
keep	homosexual	RANDOM
modernism	genre	HYPER
key	sock	RANDOM
lazy	sound	RANDOM
closeness	openness	ANT
inspiring	uninspiring	ANT
destitute	needy	SYN
capricious	whimsical	SYN
aneurism	upset	HYPER
byte	unit	HYPER
zag	zig	SYN
hickey	zit	SYN
afferent	efferent	ANT
wayside	transit	PART_OF
times	operation	HYPER
monism	pluralism	ANT
rebuild	reconstruct	SYN
puffer	pufferfish	PART_OF
monotheism	polytheism	ANT
suspend	expel	HYPER
cental	cwt	SYN
excusable	inexcusable	ANT
free-lance	freelancer	SYN
adjustment	allowance	SYN
revel	wassail	SYN
cancer	race	RANDOM
nonspecific	specific	ANT
prologue	theatre	PART_OF
vestibule	area	HYPER
mackerel	shiner	PART_OF
care	business	RANDOM
centimeter	metre	PART_OF
interstate	intrastate	ANT
admire	produce	RANDOM
udder	nanny	PART_OF
activity	inactivity	ANT
intoned	singsong	SYN
node	stalk	PART_OF
grille	lattice	SYN
disfavour	inclination	HYPER
console	soothe	SYN
channel	impart	SYN
manly	unmanly	ANT
certify	authorise	HYPER
buffer	auto	PART_OF
dominant	recessive	ANT
trafficker	vender	SYN
undue	unreasonable	SYN
note	trip	RANDOM
deciduous	evergreen	ANT
saree	sari	SYN
approvingly	disapprovingly	ANT
absolution	penance	PART_OF
concealed	unconcealed	ANT
farther	further	SYN
canvas	tent	HYPER
honeycomb	beehive	PART_OF
descent	lineage	SYN
stymie	position	HYPER
bathtub	all	RANDOM
lift	quiet	RANDOM
mix	excitement	RANDOM
credits	flick	PART_OF
unfortunately	unluckily	SYN
huffing	exhalation	HYPER
extrinsic	intrinsic	ANT
aerobic	anaerobic	ANT
acidity	alkalinity	ANT
abstract	concrete	ANT
slaughter	butchering	PART_OF
upstairs	building	PART_OF
dialectic	arts	HYPER
dram	lb	PART_OF
beginning	ending	ANT
neck	mineral	RANDOM
me	soldier	RANDOM
bike	soft	RANDOM
sockeye	salmon	HYPER
chili	cayenne	PART_OF
misdirect	profane	SYN
apartment	old	RANDOM
fostering	upbringing	SYN
home	succeed	RANDOM
midfield	bowl	PART_OF
passerby	traveler	HYPER
hyperthermia	hypothermia	ANT
dateline	despatch	PART_OF
boot	see	RANDOM
casserole	victuals	HYPER
sicken	harm	HYPER
shaven	unshaven	ANT
lung	drug	RANDOM
gleam	glint	SYN
matrix	dactyl	PART_OF
chute	gutter	HYPER
impractical	windy	SYN
party	cover	RANDOM
heaven	paradise	SYN
add	ordinary	RANDOM
passing	modification	HYPER
supplanting	substitution	HYPER
buffet	dwelling	PART_OF
con	pro	ANT
fairly	somewhat	SYN
amused	diverted	SYN
goof	sin	SYN
little	desert	RANDOM
horizon	profile	PART_OF
bluff	falsification	HYPER
bilk	thwart	SYN
pyramid	pose	HYPER
constitutional	constitutive	SYN
barb	lance	PART_OF
folly	wisdom	ANT
interjection	interpolation	SYN
guerrilla	irregular	SYN
hyperthyroidism	hypothyroidism	ANT
indoctrinate	instruct	HYPER
class	construction	RANDOM
murder	succeed	RANDOM
sauce	condiment	HYPER
stuck	unstuck	ANT
shanty	vocal	HYPER
rainforest	botany	HYPER
manhandle	palm	HYPER
peace	distress	RANDOM
danger	safety	ANT
call	silverware	RANDOM
collected	gathered	SYN
extra	special	SYN
chest	wagon	RANDOM
slipknot	gin	PART_OF
carry	reduce	RANDOM
jaunt	outing	SYN
superbly	wondrously	SYN
norther	northerly	SYN
athlete	run	RANDOM
class	escape	RANDOM
springer	arcade	PART_OF
bouncy	spirited	SYN
technicality	triviality	SYN
absolute	relative	ANT
steadiness	unsteadiness	ANT
lawfully	unlawfully	ANT
australia	walk	RANDOM
fellow	twosome	PART_OF
self-defense	protection	HYPER
shipper	businessperson	HYPER
bottomed	bottomless	ANT
quarry	unfortunate	HYPER
about	near	SYN
affection	joy	RANDOM
scratch	slit	SYN
flagellation	whipping	SYN
boss	improve	RANDOM
coarseness	roughness	HYPER
section	citrus	PART_OF
certainty	uncertainty	ANT
frequently	infrequently	ANT
rebound	hoops	PART_OF
prompt	straightaway	SYN
cosmopolitan	endemic	ANT
augur	forecast	SYN
adult	baggage	RANDOM
mousetrap	manoeuvre	HYPER
mcg	milligram	PART_OF
slouch	slump	SYN
storey	building	PART_OF
immaturity	maturity	ANT
fixer	methadone	SYN
burrow	delve	HYPER
shit	excretion	HYPER
bumper	auto	PART_OF
beef	oxen	PART_OF
immorality	morality	ANT
gravity	levity	ANT
runway	field	PART_OF
apple	individual	RANDOM
kneecap	knee	PART_OF
ascend	shadow	RANDOM
navigate	manoeuver	HYPER
escapement	timepiece	PART_OF
budge	shift	SYN
mouthpiece	respirator	PART_OF
sanctuary	church	PART_OF
slimy	ugly	SYN
molehill	mound	HYPER
neckline	jumper	PART_OF
continuous	discontinuous	ANT
rightness	wrongness	ANT
amplifier	tuner	PART_OF
add	hobby	RANDOM
blond	brunet	ANT
weft	woof	SYN
body	order	RANDOM
banister	impediment	HYPER
compose	soothe	HYPER
mercury	honey	RANDOM
swordfish	swordfish	PART_OF
fitness	unfitness	ANT
acute	obtuse	ANT
cruel	fell	SYN
pad	platform	HYPER
dunker	feeder	HYPER
slipping	slithering	SYN
endogamy	exogamy	ANT
pressure	propulsion	HYPER
informed	uninformed	ANT
begin	wear	RANDOM
sexy	unsexy	ANT
gangway	passage	HYPER
domination	mastery	SYN
drumhead	drum	PART_OF
damned	darned	SYN
civilization	darling	RANDOM
chassis	homo	PART_OF
drydock	shipyard	PART_OF
exhalation	respiration	PART_OF
button	union	RANDOM
mates	clan	HYPER
crabapple	crabapple	PART_OF
auberge	inn	SYN
bringing	delivery	SYN
turnout	route	PART_OF
debunk	expose	SYN
unworthy	worthy	ANT
chicken	ignorance	RANDOM
paunch	torso	PART_OF
maximum	minimum	ANT
knee	quadruped	PART_OF
irregularity	regularity	ANT
nuisance	bother	HYPER
best	worst	ANT
rattler	rattlesnake	SYN
marcher	traveller	HYPER
husband	night	RANDOM
outfitter	outlet	HYPER
extension	flexion	ANT
belch	burst	HYPER
hollow	pale	RANDOM
pissed	roiled	SYN
arras	ornamentation	HYPER
curious	rummy	SYN
cream	thrash	SYN
bowel	venter	PART_OF
centrifugal	centripetal	ANT
dowsing	foretelling	HYPER
footprint	tincture	HYPER
blood	something	RANDOM
minister	assist	HYPER
collet	mounting	PART_OF
pepper	pepper	PART_OF
annotate	rede	HYPER
co-pilot	flier	HYPER
anoxia	hypoxia	HYPER
series	relation	HYPER
broccoli	vegetable	HYPER
bass	instrumentalist	HYPER
muzzle	creature	PART_OF
keep	sentence	RANDOM
land	satisfaction	RANDOM
pontoon	amphibian	PART_OF
postscript	missive	PART_OF
assault	attack	PART_OF
tame	wild	ANT
indicate	signal	SYN
unwillingness	willingness	ANT
chip	paw	RANDOM
hyphenation	grouping	HYPER
multilaterally	unilaterally	ANT
lyric	generous	RANDOM
smokeless	smoky	ANT
haycock	haystack	HYPER
act	sidewalk	RANDOM
shaft	plume	PART_OF
initiative	maiden	SYN
disloyal	loyal	ANT
breech	cask	PART_OF
skipjack	bonito	HYPER
midbrain	caput	PART_OF
initiatory	maiden	SYN
minute	tie	RANDOM
bowl	throw	RANDOM
tracked	trackless	ANT
adventure	jeopardize	SYN
nadir	zenith	ANT
fatigue	assignment	HYPER
hole	heat	RANDOM
winnow	decide	HYPER
stair	stairway	PART_OF
outtake	exposure	HYPER
bridge	rooster	RANDOM
hertz	kilohertz	PART_OF
oxygen	sing	RANDOM
mississippi	design	RANDOM
crib	crib	PART_OF
disassembly	dismantling	SYN
hurried	unhurried	ANT
organ	sight	RANDOM
deckhand	roustabout	SYN
portico	structure	HYPER
mercury	spouse	RANDOM
lug	lugger	PART_OF
export	import	ANT
rhombus	quadrangle	HYPER
uphill	ascent	HYPER
photosensitivity	sense	HYPER
mobilise	collect	HYPER
shelter	expend	HYPER
close	tank	RANDOM
cinchona	bark	HYPER
gap	disagreement	HYPER
mouse	minute	RANDOM
zip	frock	PART_OF
history	university	RANDOM
bit	unique	RANDOM
monitor	skeleton	RANDOM
audition	hearing	SYN
dullness	sharpness	ANT
former	latter	ANT
aggregator	collector	SYN
pad	canine	PART_OF
fifth	position	HYPER
human	tight	RANDOM
floorboard	auto	PART_OF
call	rule	RANDOM
ace	hotshot	SYN
parade	promenade	SYN
ceiling	distress	RANDOM
found	lost	ANT
delinquency	nonpayment	HYPER
honeyed	syrupy	SYN
aboriginal	primeval	SYN
tons	wads	SYN
skull	creature	PART_OF
quad	thigh	PART_OF
insensible	sensible	ANT
sprain	twist	SYN
dove	hawk	ANT
liquidator	someone	HYPER
leak	lift	RANDOM
pea	pea	PART_OF
orange	tail	RANDOM
quoin	edifice	PART_OF
leaf	mean	RANDOM
crude	raw	SYN
abut	adjoin	HYPER
pollock	pollack	PART_OF
coping	building	PART_OF
begin	tie	RANDOM
modern	satisfy	RANDOM
kick	recoil	SYN
chain	outside	RANDOM
countertop	counter	PART_OF
buy	hold	RANDOM
active	story	RANDOM
hope	raise	RANDOM
gut	stomach	PART_OF
bridge	mortal	RANDOM
interloper	someone	HYPER
looseness	tightness	ANT
coastal	inland	ANT
knob	steel	PART_OF
attention	inattention	ANT
discipline	indiscipline	ANT
swerve	yaw	SYN
haggling	wrangling	SYN
sonar	sub	PART_OF
crossroad	route	PART_OF
index	dull	RANDOM
pass	cigarette	RANDOM
intelligence	stupidity	ANT
wedge	wedgie	PART_OF
add	flower	RANDOM
night	family	RANDOM
key	fashion	RANDOM
ambidextrous	right-handed	ANT
abundance	scarcity	ANT
caper	frolic	SYN
freezing	activity	HYPER
riff	riffle	SYN
retread	modify	HYPER
settled	unsettled	ANT
gig	hook	HYPER
just	unjust	ANT
dado	plinth	PART_OF
back	word	RANDOM
pavan	pavane	SYN
assisted	unassisted	ANT
concurrent	simultaneous	SYN
peg	fastening	HYPER
deservedly	undeservedly	ANT
hardness	stiffness	SYN
activation	inactivation	ANT
strengthening	weakening	ANT
chair	writer	RANDOM
aperture	scope	PART_OF
lower	connect	RANDOM
ink	low	RANDOM
pinion	bat	PART_OF
bazar	outlet	HYPER
big	side	RANDOM
citizen	noncitizen	ANT
odor	smell	SYN
lady	waterfall	RANDOM
machine	justice	RANDOM
lax	tense	ANT
condenser	ignition	PART_OF
shank	coffeepot	PART_OF
telling	informing	HYPER
drift	freewheel	SYN
stint	provide	HYPER
hoop	barrel	PART_OF
frat	guild	HYPER
divinity	immortal	SYN
greens	veggie	HYPER
cellar	relief	RANDOM
contaminated	uncontaminated	ANT
evenness	unevenness	ANT
reticle	binoculars	PART_OF
horizontal	inclined	ANT
parent	penis	RANDOM
prostrate	modify	HYPER
babble	clack	HYPER
zip	pant	PART_OF
cover-up	activity	HYPER
threshold	threshold	PART_OF
deviation	divergence	SYN
stressed	unstressed	ANT
garage	edifice	HYPER
annual	one-year	SYN
mesh	ft	PART_OF
scrawny	scrubby	SYN
sharpness	softness	ANT
medicine	conflict	RANDOM
centralisation	assembling	HYPER
custom-made	ready-made	ANT
derail	undermine	HYPER
scapula	torso	PART_OF
hare	hare	PART_OF
cranky	tender	SYN
hike	go	HYPER
fanny	torso	PART_OF
mitt	homo	PART_OF
change	man	RANDOM
recur	resort	SYN
scratch	scratching	SYN
navel	torso	PART_OF
note	charge	RANDOM
nonsurgical	surgical	ANT
41st	forty-first	SYN
charitable	uncharitable	ANT
placekicker	kicker	HYPER
level	fruit	RANDOM
repay	retort	SYN
augur	seer	HYPER
sorority	gild	HYPER
convergence	divergence	ANT
library	performance	RANDOM
commode	dwelling	PART_OF
civilization	belief	RANDOM
rectify	refine	SYN
centavo	dobra	PART_OF
calf	tool	RANDOM
foul-smelling	stinking	SYN
lemon	lemon	PART_OF
affirmative	negative	ANT
mankind	mind	RANDOM
resection	operation	HYPER
potion	potable	HYPER
refined	unrefined	ANT
battery	attack	HYPER
consignment	commodity	HYPER
explicable	inexplicable	ANT
seraglio	serail	SYN
golfing	playing	HYPER
counter	dwelling	PART_OF
contrivance	convenience	SYN
circle	round	SYN
sadist	deviate	HYPER
incoherence	substance	HYPER
mississippi	program	RANDOM
interchange	transpose	SYN
detector	tuner	PART_OF
insemination	copulation	PART_OF
perfect	ignite	RANDOM
jog	consume	RANDOM
upstage	theatre	PART_OF
minister	refuse	RANDOM
beldame	witch	SYN
connected	unconnected	ANT
first	last	ANT
map	honesty	RANDOM
slowing	modification	HYPER
board	set	RANDOM
cross	continue	HYPER
range	stove	SYN
honesty	excitement	RANDOM
adorable	endearing	SYN
finder	spotter	SYN
moralism	locution	HYPER
schoolwork	labor	HYPER
veil	placenta	PART_OF
differential	computation	HYPER
organized	unorganized	ANT
implicate	concern	HYPER
rutabaga	swede	PART_OF
joint	movie	RANDOM
assimilation	learning	HYPER
unilateralist	advocate	HYPER
inviting	uninviting	ANT
milliliter	ml	SYN
independence	sad	RANDOM
japan	vision	RANDOM
artificial	natural	ANT
line	cool	RANDOM
insignificance	significance	ANT
exclude	lack	HYPER
lease	outside	RANDOM
proscenium	theater	PART_OF
visor	helmet	PART_OF
car	contaminate	RANDOM
kettle	tympanum	SYN
image	phrase	RANDOM
whorl	hairdo	PART_OF
swallowtail	tails	PART_OF
cinch	harness	PART_OF
boredom	save	RANDOM
board	recreation	RANDOM
barrage	battery	SYN
prep	pedagogy	PART_OF
confident	diffident	ANT
middle	reward	RANDOM
ceiling	mature	RANDOM
ovary	blossom	PART_OF
desolation	destruction	HYPER
federal	unitary	ANT
land	reward	RANDOM
check	inaction	HYPER
dissonance	harmony	ANT
burn	politician	RANDOM
productive	unproductive	ANT
signed	unsigned	ANT
mil	inch	PART_OF
insemination	relation	PART_OF
husband	rare	RANDOM
knowledge	illness	RANDOM
calf	shank	PART_OF
numerical	verbal	ANT
touched	untouched	ANT
groovy	neat	SYN
subscript	superscript	ANT
hyperthermia	hypothermia	ANT
doubter	skeptic	SYN
quarter	quintal	PART_OF
format	publication	PART_OF
bird	bite	RANDOM
fruitful	unfruitful	ANT
equivocal	unequivocal	ANT
awful	fearsome	SYN
steerage	navigation	PART_OF
brusquely	roundly	SYN
prospective	retrospective	ANT
hamster	placental	HYPER
bony	pinched	SYN
coherence	incoherence	ANT
unvoiced	voiced	ANT
approval	commendation	SYN
runner	sled	PART_OF
anatomy	homo	PART_OF
assault	onset	PART_OF
render	submit	SYN
pilgrim	worshipper	HYPER
justly	unjustly	ANT
peristome	capsule	PART_OF
filled	unfilled	ANT
arc	arch	SYN
atonality	tonality	ANT
bulwark	munition	PART_OF
evasiveness	dishonesty	HYPER
examine	investigate	HYPER
delegating	management	HYPER
catch	full	RANDOM
naked	raw	SYN
mock	treat	HYPER
non-proliferation	proliferation	ANT
manufacture	sour	RANDOM
samizdat	medium	HYPER
gunstock	artillery	PART_OF
climb	successful	RANDOM
gutter	saddleback	PART_OF
banister	bannister	SYN
maroon	pyrotechnic	HYPER
choir	sanctuary	PART_OF
acting	arts	HYPER
barb	plumage	PART_OF
echo	resound	SYN
lie	kid	RANDOM
evade	hedge	SYN
exhort	encourage	HYPER
vigour	vim	SYN
legged	legless	ANT
lens	error	RANDOM
sampler	variety	HYPER
grafting	combination	HYPER
orchestra	theatre	PART_OF
nose	problem	RANDOM
conglomeration	assemblage	HYPER
image	machine	RANDOM
account	human	RANDOM
aileron	airfoil	HYPER
bolide	fireball	SYN
delicacy	nutrition	HYPER
allopatric	sympatric	ANT
crossing	crossroad	SYN
nastiness	niceness	ANT
aperture	oculus	PART_OF
image	unhappy	RANDOM
foreshore	seashore	PART_OF
wardrobe	wearable	PART_OF
episode	series	PART_OF
blood	strike	RANDOM
main	infrastructure	PART_OF
mammal	injure	RANDOM
monochromatic	polychromatic	ANT
crevasse	crevice	HYPER
caper	bound	HYPER
nothing	peace	RANDOM
hopeful	hopeless	ANT
general	specific	ANT
shield	mollusc	PART_OF
screening	artifact	HYPER
hot	race	RANDOM
dock	harbour	PART_OF
round	conception	HYPER
dramatize	embroider	SYN
shift	alter	HYPER
cell	gift	RANDOM
illegitimacy	legitimacy	ANT
installment	serial	PART_OF
boss	spread	RANDOM
seersucker	textile	HYPER
minute	happy	RANDOM
caressing	arousal	HYPER
pepsin	catalyst	HYPER
chicken	interest	RANDOM
adjective	substantive	ANT
pad	mitt	PART_OF
offspring	airplane	RANDOM
forehead	skull	PART_OF
remind	interact	HYPER
intersection	route	PART_OF
slash	wound	HYPER
periwinkle	winkle	SYN
serial	broadcast	HYPER
strut	swagger	SYN
systematic	unsystematic	ANT
wristband	sleeve	PART_OF
aquatic	terrestrial	ANT
illness	mobile	RANDOM
burn	marry	RANDOM
bruise	wound	HYPER
effector	receptor	ANT
disburse	transfer	HYPER
abridged	unabridged	ANT
self-protection	protection	HYPER
arouse	alter	HYPER
granduncle	great-uncle	SYN
rebelliousness	intractability	HYPER
dramatic	lyric	ANT
nonpartisan	partisan	ANT
stump	wicket	PART_OF
major	minor	ANT
indecent	unseemly	SYN
evermore	forevermore	SYN
credible	incredible	ANT
cryptography	cryptology	SYN
ratan	rattan	SYN
expose	uncover	SYN
away	forth	SYN
saturated	unsaturated	ANT
brightness	dullness	ANT
clink	slammer	SYN
lecturing	course	PART_OF
truthful	untruthful	ANT
bar	health	RANDOM
hop	share	RANDOM
infuriate	arouse	HYPER
scattering	extinction	PART_OF
adjustment	readjustment	SYN
classify	relegate	SYN
sweep	orbit	HYPER
like	pagan	RANDOM
rail	railway	HYPER
bird	gang	RANDOM
homosexual	confidence	RANDOM
throat	neck	PART_OF
ironmonger	outlet	HYPER
plank	pose	HYPER
peephole	opening	HYPER
jail	faith	RANDOM
tort	activity	HYPER
sacrum	hip	PART_OF
adventure	tooth	RANDOM
buns	can	SYN
predictability	unpredictability	ANT
seriousness	sincerity	SYN
there	thither	SYN
snapper	snapper	PART_OF
empennage	fuselage	PART_OF
narrowing	widening	ANT
hatful	plenty	SYN
paper	pencil	RANDOM
straddle	motion	HYPER
make	rock	RANDOM
joint	like	RANDOM
language	fix	RANDOM
offer	supply	HYPER
champ	chomp	SYN
caliph	khalifah	SYN
carry	powerful	RANDOM
heighten	sharpen	SYN
home	test	RANDOM
fontanelle	skull	PART_OF
songster	songwriter	SYN
ample	meager	ANT
barrage	attack	HYPER
worrying	motion	HYPER
convinced	unconvinced	ANT
garish	tatty	SYN
adamant	inexorable	SYN
hill	ignorance	RANDOM
atypical	typical	ANT
care	highway	RANDOM
mankind	powerful	RANDOM
fellow	couplet	PART_OF
teens	adulthood	PART_OF
high-resolution	low-resolution	ANT
bind	text	RANDOM
mid-seventies	age	PART_OF
irreverently	reverently	ANT
strap	bra	PART_OF
ocean	plot	RANDOM
like	skeleton	RANDOM
capitol	edifice	HYPER
evaluation	assessment	HYPER
screaming	utterance	HYPER
destabilization	stabilization	ANT
homosexual	communicate	RANDOM
distribute	stagger	SYN
eyelet	pall	PART_OF
hinge	edifice	PART_OF
nonracial	racial	ANT
micrometer	mm	PART_OF
aspirate	enunciate	HYPER
refrain	vocal	PART_OF
marrow	nourishment	HYPER
deceleration	alteration	HYPER
foreskin	button	PART_OF
impracticality	practicality	ANT
adequate	inadequate	ANT
pen	harvest	RANDOM
cypher	nil	SYN
specify	elucidate	HYPER
umbilical	fetus	PART_OF
opine	anticipate	HYPER
hearty	satisfying	SYN
condyle	bone	PART_OF
egress	issue	SYN
flintlock	flintlock	PART_OF
stalker	footer	HYPER
invertebrate	vertebrate	ANT
replacement	filling	HYPER
certain	uncertain	ANT
summery	vernal	ANT
dangerous	life-threatening	SYN
sold	unsold	ANT
appendage	outgrowth	SYN
mien	presence	SYN
rap	tap	SYN
fairly	unfairly	ANT
legion	numerous	SYN
gimmick	twist	SYN
leader	order	RANDOM
few	many	ANT
pod	aeroplane	PART_OF
consummate	masterful	SYN
dusk	eve	PART_OF
nub	prominence	HYPER
galley	airliner	PART_OF
croak	expire	SYN
gravity	levity	ANT
muse	ruminate	SYN
punk	sleazy	SYN
lobby	communication	RANDOM
tuner	wireless	PART_OF
labor	mail	RANDOM
cart	hale	SYN
allspice	allspice	PART_OF
boot	run	RANDOM
ball	time	RANDOM
seventies	age	PART_OF
experimenter	being	HYPER
upright	goalpost	PART_OF
inflow	outflow	ANT
r	diameter	PART_OF
intestine	venter	PART_OF
affection	gear	RANDOM
colossus	heavyweight	SYN
track	tramway	PART_OF
resell	transfer	HYPER
hurt	relax	RANDOM
brutally	viciously	SYN
saffron	saffron	PART_OF
conservatism	conservativism	SYN
evenness	unevenness	ANT
shank	clubhead	PART_OF
repatriate	national	HYPER
nanosecond	millisecond	PART_OF
adopt	accept	HYPER
canto	subdivision	HYPER
import	traveler	HYPER
action	suck	RANDOM
floater	grounds	HYPER
recommit	reach	HYPER
look	tree	RANDOM
evocative	redolent	SYN
gibe	jeer	SYN
aft	fore	ANT
meatless	meaty	ANT
rotor	stator	ANT
endorsement	sanction	SYN
belt	medicine	RANDOM
centrifuge	spin	HYPER
lock	reproduce	RANDOM
low	view	RANDOM
capitalistic	socialistic	ANT
shareholder	stockholder	SYN
dude	sheik	SYN
fifties	maturity	PART_OF
fractious	refractory	SYN
blood	gang	RANDOM
approach	open	RANDOM
lens	fashion	RANDOM
span	transit	PART_OF
clove	clove	PART_OF
spatter	spattering	SYN
boss	ideology	RANDOM
hooray	approval	HYPER
borage	borage	PART_OF
retardation	happening	HYPER
nonpartisan	partisan	ANT
bill	meat	RANDOM
corporeal	incorporeal	ANT
digger	excavator	SYN
conclusively	inconclusively	ANT
distinct	trenchant	SYN
boil	turn	RANDOM
still	modify	HYPER
delegate	designate	SYN
adroit	maladroit	ANT
spout	spurt	SYN
barbarism	inhumanity	HYPER
item	token	SYN
thesis	premise	HYPER
gist	substance	SYN
royalty	cost	HYPER
insufficiently	sufficiently	ANT
perpetual	unremitting	SYN
ore	krone	PART_OF
rump	torso	PART_OF
mate	pencil	RANDOM
furnished	unfurnished	ANT
seigneury	billet	HYPER
calve	deliver	HYPER
drawer	sideboard	PART_OF
buying	purchasing	SYN
joint	proton	RANDOM
immobility	mobility	ANT
checker	investigator	HYPER
gripe	kick	HYPER
concealing	revealing	ANT
ancestor	descendant	ANT
ace	vie	HYPER
summit	tiptop	SYN
actually	really	SYN
curb	kerb	SYN
deprecating	slighting	SYN
proscription	rejection	HYPER
landing	edifice	PART_OF
buggy	daft	SYN
cheer	assess	HYPER
microscopic	microscopical	SYN
like	west	RANDOM
horn	television	RANDOM
captain	soldier	RANDOM
bulge	bump	SYN
ford	watercourse	PART_OF
rig	turnout	SYN
stocky	thick	SYN
cripple	lame	SYN
atomism	holism	ANT
adhesion	stickiness	HYPER
invisibility	visibility	ANT
lace	pass	RANDOM
dissuasion	persuasion	ANT
jail	melt	RANDOM
footlights	apron	PART_OF
slop	supply	HYPER
narrowing	tapering	SYN
figure	somebody	PART_OF
two-seater	auto	HYPER
quack	trickster	HYPER
picket	scout	SYN
gearing	engine	PART_OF
nonsteroidal	steroidal	ANT
atmosphere	weak	RANDOM
snafu	bungle	HYPER
ceilinged	floored	ANT
birthday	old	RANDOM
submariner	sailor	HYPER
gladiolus	thorax	PART_OF
countdown	tally	HYPER
hayloft	barn	PART_OF
judge	lock	RANDOM
accessory	supplement	SYN
liquid	nasty	RANDOM
eyebrow	homo	PART_OF
extraversion	introversion	ANT
gusset	garment	PART_OF
tombstone	grave	PART_OF
destination	missive	PART_OF
breast	smoke	RANDOM
deduct	subtract	SYN
antipathy	distaste	SYN
eaves	edifice	PART_OF
one-piece	two-piece	ANT
touchdown	landing	HYPER
fate	supernatural	PART_OF
past	pain	RANDOM
likely	potential	SYN
flagellum	semen	PART_OF
clang	crash	SYN
characteristic	uncharacteristic	ANT
mountain	person	RANDOM
eyelet	mantle	PART_OF
lath	latticework	PART_OF
suckling	supply	HYPER
turbofan	turbofan	PART_OF
paddle	displace	HYPER
authorised	authorized	SYN
published	unpublished	ANT
stomach	torso	PART_OF
deaf	hearing	ANT
blast	pillory	SYN
bed	study	RANDOM
appropriately	inappropriately	ANT
labor	tall	RANDOM
mix	paint	RANDOM
estate	nation	PART_OF
egalitarian	elitist	ANT
illiteracy	literacy	ANT
reconsideration	rethink	SYN
orange	dictionary	RANDOM
faced	faceless	ANT
pesticide	stuff	HYPER
mil	dl	PART_OF
adapter	instrumentality	HYPER
angular	rounded	ANT
level	reward	RANDOM
prow	front	HYPER
apartment	simple	RANDOM
dope	skunk	SYN
arming	disarming	ANT
degraded	profligate	SYN
nonsectarian	sectarian	ANT
hook	solicit	SYN
erotica	porno	SYN
improperly	properly	ANT
stake	gamble	HYPER
scanning	replication	HYPER
middle	venus	RANDOM
harrier	wrongdoer	HYPER
renege	cards	PART_OF
husband	page	RANDOM
disfavor	attitude	HYPER
sunshade	shelter	HYPER
scoffing	disrespect	HYPER
case	unkind	RANDOM
abroad	afield	SYN
agency	representation	SYN
explosion	plosive	PART_OF
leaded	unleaded	ANT
junkie	junky	SYN
immaturity	maturity	ANT
posing	sitting	SYN
stealing	thievery	SYN
downstage	upstage	ANT
falling	rising	ANT
adult	cry	RANDOM
jacket	south	RANDOM
disrepute	repute	ANT
pen	displease	RANDOM
tusk	boar	PART_OF
inhibit	confine	HYPER
cone	optic	PART_OF
brawl	do	SYN
advantage	disadvantage	ANT
foster	enliven	HYPER
clause	papers	PART_OF
midriff	torso	PART_OF
extrusion	jut	SYN
keister	torso	PART_OF
chip	weak	RANDOM
quill	porcupine	PART_OF
forties	adulthood	PART_OF
fatal	fateful	SYN
boot	root	RANDOM
entreaty	prayer	SYN
back	problem	RANDOM
keyboard	house	RANDOM
decolonisation	decolonization	SYN
beauty	old	RANDOM
sarcoma	cancer	HYPER
dissonance	harmony	ANT
optimism	pessimism	ANT
conjunctiva	oculus	PART_OF
harness	parachute	PART_OF
penny	pound	PART_OF
mobilise	rally	SYN
hoodlum	punk	SYN
denizen	dweller	SYN
belief	molecule	RANDOM
mirror	demonstrate	HYPER
bay	aircraft	PART_OF
recollect	retrieve	SYN
style	way	SYN
pastorate	clergy	HYPER
exaltation	zodiac	PART_OF
improbability	probability	ANT
appear	snow	RANDOM
marionette	figure	HYPER
crossing	route	PART_OF
sandpaper	abrasive	HYPER
bunter	batter	HYPER
optimistic	pessimistic	ANT
quintet	assemblage	HYPER
stranger	someone	HYPER
cortex	optic	PART_OF
clip	couple	RANDOM
heterozygous	homozygous	ANT
chlorophyll	colour	HYPER
cloud	mild	RANDOM
bosh	twaddle	SYN
unfounded	wild	SYN
call	melt	RANDOM
intelligence	message	HYPER
buttonhole	garment	PART_OF
heterogeneity	homogeneity	ANT
distinguishable	indistinguishable	ANT
modern	gate	RANDOM
chip	flex	RANDOM
medlar	medlar	PART_OF
cosmology	philosophy	HYPER
diaphragm	torso	PART_OF
planting	activity	HYPER
warfarin	medication	HYPER
nanometer	micrometer	PART_OF
outfox	overreach	SYN
leading	stellar	SYN
bowl	bowling	PART_OF
admiration	liking	HYPER
goop	gunk	SYN
fertility	infertility	ANT
acquaintance	stranger	ANT
web	plume	PART_OF
progressive	regressive	ANT
tourer	tourist	SYN
fovea	retina	PART_OF
cockle	ripple	SYN
nay	yea	ANT
blade	design	RANDOM
cardinal	ordinal	ANT
anode	cathode	ANT
heterosexual	soil	RANDOM
reserved	unreserved	ANT
axon	neuron	PART_OF
benefit	molecule	RANDOM
lie	lazy	RANDOM
prick	shaft	SYN
explosion	discharge	HYPER
submerge	plunge	HYPER
nonpayment	payment	ANT
fingerprint	mar	HYPER
neck	screw	RANDOM
ripcord	chute	PART_OF
ireland	floor	RANDOM
profundity	superficiality	ANT
project	visualise	SYN
fitness	unfitness	ANT
slur	lessen	HYPER
retirement	going	HYPER
steamed	stung	SYN
appreciation	depreciation	ANT
berm	route	PART_OF
appear	low	RANDOM
captive	intent	SYN
approach	down	RANDOM
morpheme	constituent	HYPER
flush	thrill	SYN
turd	excretion	HYPER
judge	log	RANDOM
gam	herd	HYPER
bed	reason	RANDOM
past	lid	RANDOM
tiptop	topnotch	SYN
complexity	simplicity	ANT
emergency	brake	HYPER
patriot	national	HYPER
cornice	entablature	PART_OF
acceleration	deceleration	ANT
express	limited	SYN
pacesetter	model	HYPER
deplorable	wretched	SYN
nm	mm	PART_OF
irritation	provocation	SYN
illegality	legality	ANT
intelligible	understandable	SYN
bedchamber	dwelling	PART_OF
shake	artifact	HYPER
paper	shade	RANDOM
jeering	disrespect	HYPER
unwillingly	willingly	ANT
pontifex	reverend	HYPER
mix	write	RANDOM
muzzle	beast	PART_OF
inch	pace	PART_OF
arbor	mandrel	SYN
slut	pig	HYPER
lace	mature	RANDOM
meter	hm	PART_OF
subsistence	living	HYPER
tactician	planner	HYPER
loin	quadruped	PART_OF
thorax	arthropod	PART_OF
griot	storyteller	HYPER
disinflation	inflation	ANT
cc	cl	PART_OF
fleer	scorn	HYPER
shrug	motion	HYPER
case	recycle	RANDOM
splatter	sputtering	SYN
indoor	outdoor	ANT
examine	canvass	HYPER
peace	orange	RANDOM
recto	verso	ANT
borrower	lender	ANT
one-piece	three-piece	ANT
dispense	treat	HYPER
large	trust	RANDOM
tasteless	tasty	ANT
illegitimate	legitimate	ANT
pectoralis	torso	PART_OF
beak	unhappiness	RANDOM
beef	divide	RANDOM
athletic	gymnastic	SYN
reticle	eyepiece	PART_OF
shock	suspension	PART_OF
acceptably	unacceptably	ANT
potash	caustic	HYPER
belief	language	RANDOM
scruple	drachma	PART_OF
viewfinder	scope	PART_OF
hi	howdy	SYN
labor	add	RANDOM
cunning	sly	SYN
oxygen	step	RANDOM
bathtub	domicile	PART_OF
movie	transportation	RANDOM
tunnel	passage	HYPER
note	pillow	RANDOM
calamus	calamus	PART_OF
telomere	nucleus	PART_OF
grateful	ungrateful	ANT
sash	edifice	PART_OF
catalase	protein	HYPER
timpani	tympani	SYN
illegible	legible	ANT
homosexual	potato	RANDOM
high	goal	RANDOM
listen	grip	RANDOM
ally	nation	HYPER
weenie	hotdog	PART_OF
homespun	tweedy	SYN
guilt	innocence	ANT
penis	vacuum	RANDOM
mankind	life	RANDOM
board	emotion	RANDOM
cl	dl	PART_OF
quarter	hr	PART_OF
irreligious	religious	ANT
clear	word	RANDOM
ingenue	thespian	HYPER
benefit	hat	RANDOM
bat	present	RANDOM
lock	enlightenment	RANDOM
sow	broadcast	HYPER
lace	mail	RANDOM
alfalfa	lucerne	SYN
lie	television	RANDOM
aria	opera	PART_OF
sediment	pose	HYPER
chapter	land	RANDOM
boyfriend	fasten	RANDOM
hot	tank	RANDOM
click	ratchet	PART_OF
faultless	immaculate	SYN
extrasensory	sensory	ANT
anticyclone	cyclone	ANT
wristband	garment	PART_OF
pleasantness	unpleasantness	ANT
dragnet	scheme	HYPER
itch	itchiness	SYN
hypnotised	mesmerized	SYN
cadet	plebe	SYN
bonnet	covering	HYPER
drawer	counter	PART_OF
chalk	meth	SYN
boat	lover	RANDOM
intrude	breach	HYPER
hokey	slushy	SYN
disgorgement	regurgitation	SYN
object	sea	RANDOM
elude	sidestep	SYN
ribbon	laurels	HYPER
wreck	mishap	HYPER
anchorage	harbour	PART_OF
contented	discontented	ANT
appear	noble	RANDOM
appraise	measure	SYN
parlour	habitation	PART_OF
arithmetic	bridge	RANDOM
calm	ingredient	RANDOM
jacket	kind	RANDOM
humility	event	RANDOM
scrub	cleanup	HYPER
breather	sub	PART_OF
exogamy	intermarriage	SYN
pixel	display	PART_OF
bodkin	hairpin	HYPER
brave	waterfall	RANDOM
mouthful	portion	PART_OF
high	ideology	RANDOM
intolerance	tolerance	ANT
assumption	cheek	HYPER
hooter	auto	PART_OF
disloyalty	loyalty	ANT
goad	urging	SYN
nostalgia	yearning	HYPER
secretary	assistant	HYPER
lazy	add	RANDOM
disastrous	fateful	SYN
bureau	furnishing	HYPER
swig	ingestion	HYPER
obscurity	prominence	ANT
mystical	occult	SYN
promiscuous	wanton	SYN
coddle	pamper	SYN
lube	lubricant	SYN
spearhead	shaft	PART_OF
bowl	leaf	RANDOM
cache	stash	SYN
key	furnish	HYPER
reservation	doubt	HYPER
balusters	balcony	PART_OF
hierarchy	scheme	PART_OF
submergence	submerging	SYN
digit	vertebrate	PART_OF
candy	equal	RANDOM
obliquity	labor	PART_OF
asphyxiation	hypoxia	HYPER
behoove	jibe	HYPER
knowledge	nice	RANDOM
kc	megahertz	PART_OF
yield	provide	HYPER
programme	message	HYPER
tunny	tuna	PART_OF
checked	checkered	SYN
fate	occult	PART_OF
born	unborn	ANT
benign	malign	ANT
blizzard	snowstorm	SYN
chicken	hate	RANDOM
fierce	furious	SYN
magnetic	magnetized	SYN
comprehension	incomprehension	ANT
meddle	tamper	SYN
hole	succeed	RANDOM
letter	tall	RANDOM
member	kid	RANDOM
approach	reward	RANDOM
mark	improve	RANDOM
overkill	travail	HYPER
ovoviviparous	viviparous	ANT
lower	cooler	RANDOM
frivolity	seriousness	ANT
tailgate	truck	PART_OF
unauthorized	wildcat	SYN
quill	plume	PART_OF
briony	bryony	SYN
forte	piano	ANT
thoughtful	thoughtless	ANT
sterile	unimaginative	SYN
midstream	watercourse	PART_OF
optimist	pessimist	ANT
erotica	activity	HYPER
travail	pregnancy	PART_OF
nag	kick	HYPER
prudence	sagacity	HYPER
conscript	enlist	HYPER
overturn	declare	HYPER
arabesque	artifact	HYPER
lb	cwt	PART_OF
branch	ignorance	RANDOM
headstone	span	PART_OF
cub	laddie	SYN
chocolate	piece	RANDOM
forfeiture	sacrifice	SYN
enthusiastic	unenthusiastic	ANT
carry	ignite	RANDOM
trend	tendency	HYPER
pontificate	administer	HYPER
mate	water	RANDOM
nation	time	RANDOM
damp	dampness	SYN
chapter	gown	RANDOM
keyboard	intelligent	RANDOM
exciting	unexciting	ANT
panelling	building	PART_OF
formality	informality	ANT
mistake	mouse	RANDOM
hockey	equal	RANDOM
imagine	expect	HYPER
benedictine	liqueur	HYPER
lift	sex	RANDOM
adult	fix	RANDOM
oxygen	service	RANDOM
civility	incivility	ANT
considerable	inconsiderable	ANT
preventive	medication	HYPER
bulwark	fortification	PART_OF
exclusive	inclusive	ANT
card	poster	SYN
adjudicate	judge	SYN
bat	integrity	RANDOM
mouth	pencil	RANDOM
language	ingredient	RANDOM
perhaps	possibly	SYN
effort	travail	SYN
key	trunk	RANDOM
memory	storage	SYN
prat	torso	PART_OF
additive	subtractive	ANT
intemperance	temperance	ANT
mid-twenties	maturity	PART_OF
grease	stain	SYN
loose	shade	RANDOM
locust	grasshopper	HYPER
commissioned	noncommissioned	ANT
bone	useful	RANDOM
audio	telecasting	PART_OF
clinic	hospital	PART_OF
pellet	canister	PART_OF
lobby	get	RANDOM
atmosphere	use	RANDOM
brother	sister	ANT
elan	eagerness	HYPER
armature	smoother	PART_OF
realty	belongings	HYPER
geneva	spirits	HYPER
cockle	crisp	HYPER
board	divorce	RANDOM
never-ending	unceasing	SYN
organ	train	RANDOM
mastication	feeding	PART_OF
cultivated	cultured	SYN
homelessness	status	HYPER
transfer	transference	SYN
cheek	caput	PART_OF
discover	notice	SYN
blowhole	cetacean	PART_OF
mind	correct	RANDOM
pinch	twinge	SYN
lock	sour	RANDOM
blotter	stuff	HYPER
millimeter	centimeter	PART_OF
rambling	sprawling	SYN
approval	disapproval	ANT
night	rent	RANDOM
fine-grained	powdered	SYN
undo	thwart	HYPER
ink	trip	RANDOM
jog	gay	RANDOM
galley	craft	HYPER
danger	safety	ANT
two-thirds	fraction	HYPER
lyric	bolt	RANDOM
volley	emit	HYPER
gallon	hogshead	PART_OF
pincer	crustacean	PART_OF
boss	past	RANDOM
beach	lobby	RANDOM
forgiving	unforgiving	ANT
offspring	wild	RANDOM
legato	staccato	ANT
retry	examine	HYPER
destabilisation	stabilisation	ANT
confidant	somebody	HYPER
plastination	preservation	HYPER
history	language	RANDOM
body	subject	RANDOM
unwary	wary	ANT
party	flow	RANDOM
hateful	lovable	ANT
formal	informal	ANT
chocolate	ring	RANDOM
brace	bracing	SYN
basement	increase	RANDOM
warp	weave	PART_OF
facing	cuff	PART_OF
thoughtfulness	fibre	PART_OF
actively	passively	ANT
diagonal	checkerboard	PART_OF
shank	handlebar	PART_OF
alternate	backup	HYPER
panic	anxiousness	HYPER
shin	struggle	SYN
aim	path	HYPER
cockeyed	tight	SYN
adjusted	maladjusted	ANT
loving	unloving	ANT
matter	see	RANDOM
centralized	decentralized	ANT
specialization	adjustment	HYPER
loading	ratio	HYPER
pale	extinguish	RANDOM
pedagogy	method	HYPER
boat	money	RANDOM
elongate	linear	SYN
clavier	pianoforte	PART_OF
dense	dim	SYN
compromising	uncompromising	ANT
inlet	lake	PART_OF
baseball	square	RANDOM
gelt	lolly	SYN
jail	mouse	RANDOM
hoodlum	felon	HYPER
unwrapped	wrapped	ANT
inboard	outboard	ANT
slope	elevation	PART_OF
courtship	request	HYPER
ft	pace	PART_OF
slavish	submissive	SYN
gather	tuck	SYN
bias	constellation	RANDOM
cowling	motorcar	PART_OF
imprudence	prudence	ANT
mid-fifties	adulthood	PART_OF
depot	transit	PART_OF
erection	artifact	HYPER
downtime	uptime	ANT
moiety	grouping	HYPER
illegal	legal	ANT
westerly	wester	HYPER
assemble	clay	RANDOM
difference	sameness	ANT
purposeful	purposeless	ANT
constitutional	unconstitutional	ANT
age	lifespan	PART_OF
bat	wake	RANDOM
stapes	stirrup	SYN
coverage	magnitude	HYPER
fingerboard	lute	PART_OF
pilot	engine	PART_OF
lyric	run	RANDOM
disenfranchisement	enfranchisement	ANT
inner	interior	SYN
enthusiasm	curiosity	HYPER
belief	hour	RANDOM
pint	gal	PART_OF
trice	hoist	HYPER
music	ring	RANDOM
pungency	humor	HYPER
roominess	spaciousness	SYN
mastermind	orchestrate	SYN
careful	careless	ANT
extant	extinct	ANT
foolishness	stupidity	SYN
general	particular	ANT
preamble	papers	PART_OF
frank	hotdog	PART_OF
begin	communication	RANDOM
poundage	appropriation	HYPER
steamroll	go	HYPER
blowfish	blowfish	PART_OF
insignificant	peanut	SYN
legalize	legitimise	SYN
regulated	unregulated	ANT
trimester	gestation	PART_OF
flash	expose	HYPER
babushka	kerchief	HYPER
piquancy	attribute	HYPER
programme	syllabus	SYN
tapped	untapped	ANT
minor	modest	SYN
human	pattern	RANDOM
actor	sight	RANDOM
fingerprint	blot	HYPER
mercilessly	unmercifully	SYN
ton	megaton	PART_OF
grind	mash	SYN
clergy	laity	ANT
gain	loss	ANT
swagger	gipsy	HYPER
camber	convexity	HYPER
apple	leader	RANDOM
downwards	upwards	ANT
spurring	urging	SYN
filler	cigar	PART_OF
clear	tan	RANDOM
bewilderment	mystification	SYN
fruitfully	fruitlessly	ANT
care	metal	RANDOM
burn	jail	RANDOM
rotary	route	PART_OF
vein	stain	HYPER
rambutan	rambutan	PART_OF
middle	language	RANDOM
gaunt	skeletal	SYN
chip	cultivate	RANDOM
postpone	delay	HYPER
mix	shout	RANDOM
blunted	dulled	SYN
pedal	stream	RANDOM
integrated	segregated	ANT
nanometer	millimetre	PART_OF
nonpareil	saint	SYN
impartial	partial	ANT
redo	remodel	SYN
leak	pan	RANDOM
blood	level	RANDOM
kid	flow	RANDOM
candidate	politico	HYPER
ovary	bloom	PART_OF
constrained	strained	SYN
mons	vulva	PART_OF
aggrandizement	elevation	SYN
physique	soma	SYN
busy	aluminum	RANDOM
light	mineral	RANDOM
fixed	unfixed	ANT
rocket	arise	HYPER
lesson	teaching	PART_OF
effectiveness	ineffectiveness	ANT
genital	venereal	SYN
forefoot	quadruped	PART_OF
tonic	beverage	HYPER
involved	uninvolved	ANT
talented	untalented	ANT
courtesy	demeanor	HYPER
bias	hollow	RANDOM
burden	burthen	SYN
sac	structure	HYPER
outdoorsman	someone	HYPER
coon	ringtail	SYN
comer	competitor	HYPER
chip	effect	RANDOM
bowl	follow	RANDOM
home	reproduction	RANDOM
cauliflower	cauliflower	PART_OF
midwinter	winter	PART_OF
raindrop	rainfall	PART_OF
homosexual	heat	RANDOM
distinct	indistinct	ANT
host	interact	HYPER
earmark	allot	HYPER
nook	building	PART_OF
dryness	wetness	ANT
reclamation	reparation	HYPER
lamentable	sorry	SYN
amateur	professional	ANT
pain	pin	RANDOM
lag	meantime	SYN
hole	mankind	RANDOM
breakable	unbreakable	ANT
perinatal	postnatal	ANT
bar	surface	RANDOM
pedal	parent	RANDOM
retaliate	revenge	SYN
chives	chives	PART_OF
attention	inattention	ANT
usefully	uselessly	ANT
sesquicentennial	anniversary	HYPER
inheritance	abstraction	HYPER
sprawling	straggling	SYN
ambiguous	unambiguous	ANT
sclerosis	pathology	HYPER
nucleus	climb	RANDOM
amateur	professional	ANT
unmatchable	unrivaled	SYN
eyelet	drape	PART_OF
negativity	positivity	ANT
bound	unbound	ANT
hypoxia	asphyxia	PART_OF
australia	same	RANDOM
condition	experimentation	PART_OF
bosh	drool	SYN
like	line	RANDOM
strength	weakness	ANT
pay	edge	RANDOM
panorama	ikon	HYPER
haywire	wacky	SYN
imagination	friendly	RANDOM
umbilical	foetus	PART_OF
electromagnet	circuit	PART_OF
gab	conversation	HYPER
marc	brandy	HYPER
biased	coloured	SYN
jugular	neck	PART_OF
calculus	mathematics	HYPER
timothy	timothy	PART_OF
rimless	rimmed	ANT
nineties	age	PART_OF
mammal	letter	RANDOM
rebound	basketball	PART_OF
charged	uncharged	ANT
answer	organism	RANDOM
dorsal	ventral	ANT
bicker	spat	SYN
high-risk	speculative	SYN
lash	oculus	PART_OF
turnaround	driveway	PART_OF
defensive	offensive	ANT
qualify	pronounce	HYPER
fin	figure	HYPER
apple	hat	RANDOM
medicine	floor	RANDOM
clock	middle	RANDOM
milligram	dg	PART_OF
lung	rise	RANDOM
former	latter	ANT
pedicel	pedicle	SYN
injure	land	RANDOM
terminus	infrastructure	PART_OF
fondling	kissing	SYN
knowledge	ingredient	RANDOM
agonist	antagonist	ANT
classwork	pedagogy	PART_OF
hop	friend	RANDOM
excite	stimulate	SYN
bow	island	RANDOM
fermi	angstrom	PART_OF
nation	oil	RANDOM
transplant	transplanting	SYN
kick	leap	HYPER
delay	holdup	SYN
oath	dedication	HYPER
bloodline	lineage	SYN
haddock	haddock	PART_OF
stomachache	dyspepsia	PART_OF
composition	placement	HYPER
brace	framework	PART_OF
disenfranchisement	enfranchisement	ANT
cultivated	uncultivated	ANT
consecrate	sanctify	SYN
peeler	stripper	SYN
deluge	pile	HYPER
plural	singular	ANT
envisioning	picturing	SYN
clock	liberty	RANDOM
ready	unready	ANT
dissuasion	persuasion	ANT
boldness	timidity	ANT
entire	intact	SYN
click	dawn	SYN
minute	sock	RANDOM
rewarding	unrewarding	ANT
allegiance	loyalty	HYPER
sprinkle	sprinkle	HYPER
pharmacopoeia	assemblage	HYPER
phosphatase	enzyme	HYPER
beach	sick	RANDOM
clutch	evoke	HYPER
blend	correspond	HYPER
undreamed	unimagined	SYN
injured	uninjured	ANT
boyfriend	ordinary	RANDOM
shank	cutlery	PART_OF
chapter	monitor	RANDOM
paint	mouse	RANDOM
beauty	ugliness	ANT
floodgate	penstock	PART_OF
stunt	brute	HYPER
1940s	forties	SYN
intentionally	unintentionally	ANT
impotency	potency	ANT
tunic	cloak	HYPER
butterfly	romance	SYN
imagination	south	RANDOM
loud	tatty	SYN
altered	unaltered	ANT
channel	give	RANDOM
nave	area	HYPER
ideal	nonsuch	SYN
reorganise	organise	HYPER
projecting	relieved	SYN
hollow	yard	RANDOM
draft	muster	SYN
bleacher	somebody	HYPER
choroid	optic	PART_OF
stream	course	HYPER
taxiway	airfield	PART_OF
pen	ax	RANDOM
resonant	resounding	SYN
manus	homo	PART_OF
extensor	flexor	ANT
tendinitis	tendonitis	SYN
ball	shout	RANDOM
composition	opus	SYN
loyalty	faithfulness	HYPER
butter	lock	RANDOM
animal	writer	RANDOM
critically	uncritically	ANT
disproportionate	proportionate	ANT
china	conclusion	RANDOM
deductive	inductive	ANT
irreversibility	reversibility	ANT
popular	unpopular	ANT
scan	skim	SYN
me	vision	RANDOM
adult	sleep	RANDOM
milk	equal	RANDOM
territorial	militia	PART_OF
decrement	increment	ANT
marked	pronounced	SYN
necessary	unnecessary	ANT
mustache	beard	PART_OF
birthday	exchange	RANDOM
advance	lover	RANDOM
hailstone	hail	PART_OF
informative	uninformative	ANT
mullion	building	PART_OF
hungry	thirsty	ANT
perianth	bloom	PART_OF
admire	text	RANDOM
disinflation	inflation	ANT
bully	ruffian	SYN
accord	harmonize	SYN
asset	liability	ANT
canonized	glorified	SYN
copepod	plankton	PART_OF
battle	cattle	RANDOM
objection	procedure	HYPER
grouse	grouse	PART_OF
cowling	auto	PART_OF
cheaply	expensively	ANT
hypocrite	phoney	SYN
groin	loins	PART_OF
paymaster	payer	HYPER
shift	hands	PART_OF
bundle	sheaf	SYN
inhibited	uninhibited	ANT
primarily	secondarily	ANT
annihilation	destruction	HYPER
burn	edge	RANDOM
tarragon	seasoning	HYPER
aqueous	igneous	ANT
boeuf	oxen	PART_OF
impiety	piety	ANT
inset	insert	HYPER
pedal	island	RANDOM
japan	game	RANDOM
hereditary	patrimonial	SYN
pleasantly	unpleasantly	ANT
pale	silent	RANDOM
bird	subject	RANDOM
account	bring	RANDOM
enlarged	magnified	SYN
labor	wild	RANDOM
largeness	smallness	ANT
asper	lira	PART_OF
closing	narration	PART_OF
flounder	stagger	SYN
morning	oil	RANDOM
intervention	nonintervention	ANT
can	lavatory	PART_OF
thinkable	unthinkable	ANT
drooping	droopy	SYN
barmy	kooky	SYN
extend	gesture	HYPER
stomper	walker	HYPER
quash	subjugate	SYN
shank	anchor	PART_OF
brand	steel	SYN
mantel	chimney	PART_OF
composition	substance	HYPER
extensor	flexor	ANT
defined	undefined	ANT
barbaric	uncivilized	SYN
populace	public	SYN
art	stripe	RANDOM
lady	whole	RANDOM
derisive	taunting	SYN
preserver	somebody	HYPER
arse	derriere	SYN
civilized	cultivated	SYN
puberty	youth	PART_OF
alewife	alewife	PART_OF
cyanamid	compound	HYPER
stamen	blossom	PART_OF
lift	plastic	RANDOM
mansion	sphere	PART_OF
lady	push	RANDOM
cite	credit	SYN
hollow	rear	RANDOM
homosexual	produce	RANDOM
seasonable	unseasonable	ANT
bloodless	bloody	ANT
offstage	onstage	ANT
extension	flexion	ANT
dram	pound	PART_OF
faithfulness	unfaithfulness	ANT
double	single	ANT
anthropomorphic	humanlike	SYN
advance	honey	RANDOM
militant	warring	SYN
bobble	muff	SYN
conjunct	disjunct	ANT
plastron	frock	PART_OF
proboscis	elephant	PART_OF
punished	unpunished	ANT
achiever	loser	ANT
pervert	reprobate	HYPER
baseball	trip	RANDOM
trumpeter	swan	HYPER
sense	notice	HYPER
artful	artless	ANT
desolate	scourge	SYN
buttoned	unbuttoned	ANT
elbow	covering	HYPER
fender	motorcar	PART_OF
level	plate	RANDOM
calf	calfskin	SYN
keyboard	medicine	RANDOM
demobilization	mobilization	ANT
relay	circuit	PART_OF
ingratiating	insinuating	SYN
gene	nucleus	PART_OF
irreducible	reducible	ANT
baffling	knotty	SYN
inaugural	inaugural	PART_OF
running	operation	HYPER
neb	muzzle	PART_OF
lift	mood	RANDOM
asia	fortune	RANDOM
remuneration	payroll	PART_OF
aid	life	RANDOM
arse	behind	SYN
america	suck	RANDOM
heterosexual	pillow	RANDOM
ablaze	afire	SYN
arm	less	RANDOM
rested	tired	ANT
denouement	resolution	HYPER
lobby	shadow	RANDOM
trademark	register	HYPER
impropriety	propriety	ANT
orange	snow	RANDOM
acyclic	cyclic	ANT
punning	wit	HYPER
belly	torso	PART_OF
preceding	succeeding	ANT
seasonably	unseasonably	ANT
belching	propulsion	HYPER
69	sixty-nine	SYN
codicil	will	PART_OF
garbanzo	pod	HYPER
grille	motorcar	PART_OF
quintal	t	PART_OF
wailer	unfortunate	HYPER
relaxed	tense	ANT
answer	bright	RANDOM
bounty	generosity	HYPER
primary	transformer	PART_OF
airplane	ignite	RANDOM
hg	kilo	PART_OF
victimize	victimize	HYPER
insolvency	solvency	ANT
literal	typo	SYN
coccyx	rachis	PART_OF
hollow	ride	RANDOM
taconite	ore	HYPER
nothing	same	RANDOM
narthex	basilica	PART_OF
alleviate	assuage	SYN
gig	tackle	PART_OF
premeditated	unpremeditated	ANT
harbour	seafront	PART_OF
noise	leg	RANDOM
loins	torso	PART_OF
geometrically	linearly	ANT
eddo	taro	SYN
breast	mug	RANDOM
diligent	negligent	ANT
egg-shaped	oval-shaped	SYN
parallel	perpendicular	ANT
invading	invasive	SYN
canape	appetizer	HYPER
plume	rob	SYN
millstone	gristmill	PART_OF
change	superior	RANDOM
case	pop	RANDOM
microgram	mg	PART_OF
bonito	bonito	PART_OF
oviduct	uterus	PART_OF
shrubbery	area	HYPER
go	no-go	ANT
bespeak	tell	HYPER
barb	arrow	PART_OF
bountiful	giving	SYN
obtrusive	unobtrusive	ANT
part	girl	RANDOM
cleared	uncleared	ANT
injure	object	RANDOM
threaten	augur	HYPER
necking	molding	HYPER
load	vexation	HYPER
brag	crow	SYN
igloo	hovel	HYPER
admire	bill	RANDOM
hammerhead	knucklehead	SYN
interpreter	software	HYPER
ft	rod	PART_OF
innings	cricket	PART_OF
brace	duo	SYN
ventilator	ventilation	PART_OF
potpourri	smorgasbord	SYN
monkfish	monkfish	PART_OF
infective	pathogenic	SYN
condenser	circuit	PART_OF
parser	compiler	PART_OF
sitter	stander	ANT
cps	kilohertz	PART_OF
covertly	overtly	ANT
armed	armless	ANT
parlour	abode	PART_OF
actress	shade	RANDOM
bloom	youth	PART_OF
continuation	discontinuation	ANT
acute	chronic	ANT
frequent	infrequent	ANT
buy	zero	RANDOM
suspected	unsuspected	ANT
demise	lifetime	PART_OF
drool	meaninglessness	HYPER
wounded	grouping	HYPER
kind	part	RANDOM
quarry	target	SYN
sugarless	sugary	ANT
fauna	flora	ANT
corrupt	alter	HYPER
cartwheel	cart	PART_OF
ambitious	unambitious	ANT
centime	dirham	PART_OF
dope	dumbbell	SYN
connection	somebody	HYPER
bbl	hogshead	PART_OF
lung	waterfall	RANDOM
bend	quiet	RANDOM
jump	element	RANDOM
valentine	sweetie	HYPER
disreputable	reputable	ANT
supervised	unsupervised	ANT
beak	hostility	RANDOM
aperture	optic	PART_OF
sheer	veer	SYN
expert	proficient	SYN
nonpareil	unrivalled	SYN
developed	undeveloped	ANT
blues	folksong	HYPER
clean-cut	trim	SYN
compel	obligate	SYN
whirligig	artifact	HYPER
blurry	fuzzy	SYN
fluke	blower	PART_OF
workweek	week	PART_OF
map	bush	RANDOM
flaming	fucking	SYN
ciliary	ciliate	SYN
hutch	shanty	SYN
fort	fortify	SYN
excelsior	packing	HYPER
formalism	imitation	ANT
cud	wad	SYN
stomachache	indigestion	PART_OF
animosity	hatred	HYPER
noose	lasso	PART_OF
debatable	moot	SYN
tick	arachnoid	HYPER
calosoma	beetle	HYPER
customs	duty	HYPER
draftee	volunteer	ANT
balance	imbalance	ANT
paper	sit	RANDOM
impotency	potency	ANT
carry	dribble	SYN
inspiration	breathing	PART_OF
sale	commercialism	HYPER
matter	cultivate	RANDOM
index	separation	RANDOM
bidirectional	unidirectional	ANT
lug	junk	PART_OF
gumbo	gumbo	PART_OF
bloom	word	RANDOM
fertilisation	enrichment	HYPER
fine-tune	alter	HYPER
passel	plenty	SYN
drawer	commode	PART_OF
hopefulness	hopelessness	ANT
unwritten	written	ANT
minus	plus	ANT
lush	juicer	HYPER
sloe	sloe	PART_OF
agitation	calmness	ANT
checkerboard	checkers	PART_OF
tectonics	architecture	PART_OF
inoperable	operable	ANT
alphabetic	alphabetical	SYN
prodigious	surpassing	SYN
parish	bishopric	PART_OF
bind	rock	RANDOM
nose	stock	RANDOM
cent	rupee	PART_OF
change	skyscraper	RANDOM
index	grass	RANDOM
dirham	riyal	PART_OF
rift	crevice	HYPER
loose	doorway	RANDOM
millimeter	dm	PART_OF
bind	everything	RANDOM
metaphase	mitosis	PART_OF
experienced	inexperienced	ANT
decrepit	infirm	SYN
appointment	furnishing	HYPER
insure	corroborate	HYPER
isolated	separated	SYN
homosexual	raise	RANDOM
quickly	slowly	ANT
melody	tune	SYN
exaltation	firmament	PART_OF
key	aqueduct	PART_OF
rigidity	inability	HYPER
cancer	exchange	RANDOM
suspect	being	HYPER
flexibility	inflexibility	ANT
shank	ladle	PART_OF
savage	someone	HYPER
diffidence	self-doubt	SYN
clinch	grasp	HYPER
indecisiveness	trait	HYPER
punk	tinny	SYN
plural	singular	ANT
fixation	plastination	PART_OF
cantaloupe	cantaloupe	PART_OF
epitope	antigen	PART_OF
scrawl	scribble	SYN
edda	taro	PART_OF
sen	yen	PART_OF
bow	common	RANDOM
conglomerate	corp	HYPER
catch	steal	RANDOM
ceiling	conflict	RANDOM
civilian	military	ANT
mistake	joint	RANDOM
nonprescription	prescription	ANT
commode	lavatory	PART_OF
coordinating	subordinating	ANT
murder	dry	RANDOM
scrubber	apparatus	HYPER
quaver	occurrence	HYPER
constitutive	organic	SYN
flick	pic	SYN
kitten	meet	RANDOM
jujutsu	self-defense	HYPER
monitor	healthy	RANDOM
leaning	propensity	SYN
change	train	RANDOM
rebuke	reprimand	SYN
coal	fragment	HYPER
salivate	covet	HYPER
chatty	gabby	SYN
extrovert	introvert	ANT
spurt	squirt	SYN
yearn	hanker	HYPER
precocity	intelligence	HYPER
altogether	totally	SYN
clip	open	RANDOM
chatter	visit	SYN
pike	thruway	SYN
hooky	truancy	SYN
apex	firmament	PART_OF
airplane	money	RANDOM
pathologist	medico	HYPER
car	mountain	RANDOM
member	travel	RANDOM
acme	elevation	SYN
pay	stone	RANDOM
discipline	alter	HYPER
knighthood	elite	HYPER
conditionally	unconditionally	ANT
bract	inflorescence	PART_OF
tucked	untucked	ANT
actual	potential	ANT
brisk	refreshing	SYN
garment	clothing	HYPER
seatbelt	motorcar	PART_OF
cowl	aeroplane	PART_OF
hyperthyroidism	hypothyroidism	ANT
responsibility	personality	PART_OF
amplification	gain	SYN
courtesy	discourtesy	ANT
tap	barrel	PART_OF
stabilizer	empennage	PART_OF
bad	vessel	RANDOM
shear	snip	HYPER
augmentation	diminution	ANT
demilitarize	divest	HYPER
movie	pen	RANDOM
blistering	virulent	SYN
dispensable	indispensable	ANT
correctness	incorrectness	ANT
cutting	stinging	SYN
city	unknown	RANDOM
lease	real	RANDOM
perianth	blossom	PART_OF
placenta	uterus	PART_OF
orthopedist	medico	HYPER
art	writer	RANDOM
cassava	gari	PART_OF
past	drama	RANDOM
shipping	commercialism	PART_OF
converse	transposed	SYN
folktale	folklore	PART_OF
blood	idea	RANDOM
explore	diagnose	HYPER
drained	undrained	ANT
boredom	suffer	RANDOM
box	metal	RANDOM
disincentive	incentive	ANT
misfortune	happening	HYPER
ascend	grow	RANDOM
offspring	enlightenment	RANDOM
look	ocean	RANDOM
join	roof	RANDOM
contamination	decontamination	ANT
garbanzo	chickpea	PART_OF
continuation	discontinuation	ANT
selfishness	unselfishness	ANT
listen	fireplace	RANDOM
clarity	opacity	ANT
leader	triangle	RANDOM
rotor	fridge	PART_OF
disillusion	queer	HYPER
curator	defender	HYPER
park	molecule	RANDOM
athlete	action	RANDOM
bend	nothing	RANDOM
proved	unproved	ANT
independence	spot	RANDOM
softy	weakling	HYPER
breast	enrage	RANDOM
judge	scissor	RANDOM
dissimilarity	similarity	ANT
nub	pith	SYN
carry	carry	HYPER
demoiselle	maid	HYPER
gauge	length	HYPER
expected	unexpected	ANT
moneylender	wrongdoer	HYPER
cheat	falsification	HYPER
atheism	theism	ANT
half-moon	month	PART_OF
air-to-ground	air-to-surface	SYN
extravagantly	profusely	SYN
dismissal	release	SYN
gramme	dag	PART_OF
brainstem	caput	PART_OF
habitue	patron	HYPER
choral	hymn	HYPER
vanda	orchid	HYPER
vane	oar	PART_OF
low-lying	sea-level	SYN
lid	melt	RANDOM
hyphenation	orthography	PART_OF
unworldly	worldly	ANT
bushel	quarter	PART_OF
destroyed	preserved	ANT
disapproval	substance	HYPER
adventuresome	adventurous	SYN
brocaded	raised	SYN
shot	flick	PART_OF
illness	cry	RANDOM
clean	leisure	RANDOM
apologetic	unapologetic	ANT
piggy	piglet	SYN
amplifier	wireless	PART_OF
coconut	coco	PART_OF
no	yes	ANT
cheerfulness	disposition	PART_OF
segmentation	maternity	PART_OF
lamella	os	PART_OF
climb	solution	RANDOM
contravene	negate	SYN
murder	flow	RANDOM
postage	stamp	SYN
cable	telegraph	SYN
loud	weather	RANDOM
active	join	RANDOM
conceit	humility	ANT
hurt	design	RANDOM
foundation	explanation	PART_OF
rotate	splay	SYN
bar	bars	PART_OF
crisp	crispy	SYN
geocentric	heliocentric	ANT
flame	flare	SYN
swamp	situation	HYPER
centime	franc	PART_OF
accuracy	inaccuracy	ANT
improbable	probable	ANT
frozen	unfrozen	ANT
criminalization	decriminalization	ANT
horseradish	horseradish	PART_OF
bunco	con	SYN
rescript	writing	HYPER
glow	luminescence	SYN
hamburger	hamburger	PART_OF
peppercorn	pepper	PART_OF
expound	elaborate	HYPER
spoke	cartwheel	PART_OF
aneurin	thiamine	SYN
author	paint	RANDOM
morning	study	RANDOM
jumpy	nervy	SYN
fulcrum	lever	PART_OF
scruple	ounce	PART_OF
beseeching	pleading	SYN
bats	bonkers	SYN
bat	hit	HYPER
cane	flog	SYN
boon	fate	HYPER
loud	hide	RANDOM
vane	missile	PART_OF
chew	letter	RANDOM
dizziness	lightheadedness	SYN
japan	original	RANDOM
abject	miserable	SYN
party	see	RANDOM
irritability	petulance	SYN
falter	stammer	SYN
assure	reassure	SYN
bright	chill	RANDOM
transfiguration	alteration	HYPER
canonize	extol	HYPER
shamelessness	hardiness	HYPER
clip	fixing	HYPER
jaw	vise	PART_OF
edging	carpeting	PART_OF
realistic	unrealistic	ANT
fathead	goose	SYN
bodyguard	suite	PART_OF
arch	edifice	PART_OF
adorned	unadorned	ANT
theft	felony	HYPER
overdrive	overuse	SYN
capability	incapability	ANT
gunfight	gunplay	SYN
basic	incidental	ANT
bear	carry	HYPER
basis	footing	SYN
prosperous	roaring	SYN
pad	manus	PART_OF
accommodate	provide	HYPER
moving	still	ANT
saint	regard	HYPER
catch	space	RANDOM
decumbent	recumbent	SYN
breeze	labor	HYPER
dictator	potentate	SYN
logrolling	twisting	HYPER
swoop	foray	HYPER
buck	horse	SYN
caudal	cephalic	ANT
reasonable	unreasonable	ANT
slit	opening	HYPER
comprehension	incomprehension	ANT
endometrium	uterus	PART_OF
ethical	unethical	ANT
brave	cave	RANDOM
reasonably	unreasonably	ANT
fishhook	implement	HYPER
cheer	temperament	PART_OF
starve	thirst	SYN
conciliate	placate	SYN
imagination	prison	RANDOM
agriculture	mercantilism	HYPER
guess	hypothesis	SYN
consistent	inconsistent	ANT
particular	universal	ANT
order	mood	RANDOM
impaired	unimpaired	ANT
lateen	dhow	PART_OF
catch	enjoy	RANDOM
attach	sofa	RANDOM
rod	optic	PART_OF
pound	hundredweight	PART_OF
fox	trickster	HYPER
skullcap	cranium	PART_OF
allocate	apportion	SYN
illegitimately	legitimately	ANT
direct	organize	SYN
due	undue	ANT
classification	declassification	ANT
cent	shilling	PART_OF
lunette	vault	PART_OF
cuticle	arthropod	PART_OF
agonising	harrowing	SYN
natural	unnatural	ANT
tusk	tusker	PART_OF
broom	sweep	SYN
aligned	nonaligned	ANT
horn	ugly	RANDOM
follow-on	innings	HYPER
barb	arrowhead	PART_OF
beguile	fascinate	SYN
shitty	stinking	SYN
mind	child	RANDOM
socialise	socialize	SYN
profitable	unprofitable	ANT
baffle	puzzle	SYN
exclaiming	exclamation	SYN
lose	ocean	RANDOM
raid	thieving	HYPER
crudeness	rudeness	SYN
battle	sky	RANDOM
punctuality	tardiness	ANT
starving	privation	HYPER
trace	harness	PART_OF
calf	star	RANDOM
mix	pack	RANDOM
snare	trammel	SYN
quench	squelch	SYN
clobber	cream	SYN
market	professor	RANDOM
harass	bother	HYPER
monstrosity	mutation	HYPER
chairman	direct	HYPER
grate	rankle	SYN
mamey	mamey	PART_OF
hopeful	someone	HYPER
bag	nanny	PART_OF
busy	player	RANDOM
buy	magic	RANDOM
peak	cone	PART_OF
fluting	imprint	HYPER
fairness	unfairness	ANT
booby	somebody	HYPER
gamble	investment	HYPER
formally	informally	ANT
agreeable	disagreeable	ANT
listen	ocean	RANDOM
biennial	two-year	SYN
radius	cycle	PART_OF
establishment	regime	PART_OF
stoma	tracheotomy	PART_OF
poll	homo	PART_OF
rung	ladder	PART_OF
black	nut	RANDOM
administer	administrate	SYN
enclosure	writing	HYPER
order	yard	RANDOM
novice	tyro	SYN
klondike	solitaire	HYPER
dwarf	fairy	HYPER
ore	krona	PART_OF
high	car	RANDOM
accident	radio	RANDOM
trailhead	beginning	HYPER
physique	homo	PART_OF
plodding	labor	HYPER
happily	sadly	ANT
diagonal	sloping	SYN
semi	rig	PART_OF
slog	trudge	SYN
acceptance	credence	SYN
medicine	bright	RANDOM
eaves	building	PART_OF
moving	unmoving	ANT
strap	shift	PART_OF
birth	joint	RANDOM
artillery	armament	HYPER
fibrosis	pneumoconiosis	PART_OF
administration	authorities	PART_OF
interested	uninterested	ANT
gook	slime	SYN
beach	vehicle	RANDOM
member	transport	RANDOM
credits	pic	PART_OF
bod	chassis	SYN
resistor	circuit	PART_OF
box	grain	RANDOM
matriarchal	patriarchal	ANT
curable	incurable	ANT
bathroom	unknown	RANDOM
directional	omnidirectional	ANT
bloke	feller	SYN
throttle	auto	PART_OF
chapter	destroy	RANDOM
library	rooster	RANDOM
yawn	yawning	SYN
zipper	frock	PART_OF
muse	reflect	SYN
front	field	PART_OF
anger	sour	RANDOM
slumber	status	HYPER
bike	flex	RANDOM
blade	magic	RANDOM
loading	unloading	ANT
sewing	stitching	SYN
must	thing	HYPER
labor	gestation	PART_OF
agrarian	farming	SYN
downstairs	upstairs	ANT
fairness	unfairness	ANT
nm	millimeter	PART_OF
bellybutton	venter	PART_OF
abstinent	someone	HYPER
hit	deed	HYPER
deficit	possession	HYPER
categorised	categorized	SYN
tinker	gipsy	HYPER
breadbasket	stomach	SYN
incident	episode	PART_OF
bin	satisfy	RANDOM
rotor	sander	PART_OF
flaps	aeroplane	PART_OF
rip	opening	HYPER
virtuosity	ability	HYPER
tomato	tomato	PART_OF
sculpt	sculpture	SYN
invulnerability	vulnerability	ANT
jak	jackfruit	PART_OF
civilization	write	RANDOM
atonality	tonality	ANT
fifties	adulthood	PART_OF
autoclave	disinfect	HYPER
fontanelle	braincase	PART_OF
chapter	stop	RANDOM
cortex	medulla	ANT
auditor	listener	SYN
thirties	adulthood	PART_OF
determiner	cognition	HYPER
understatement	substance	HYPER
despair	hope	ANT
anionic	cationic	ANT
nose	dislike	RANDOM
diver	loon	SYN
bark	sugar	RANDOM
derangement	unbalance	SYN
ramification	forking	PART_OF
colonic	irrigation	HYPER
identity	memory	HYPER
miss	ride	RANDOM
aisle	leave	RANDOM
inanity	meaninglessness	HYPER
nozzle	snout	SYN
add-on	supplement	SYN
bias	wife	RANDOM
bombard	displace	HYPER
boyfriend	wagon	RANDOM
freak	monster	SYN
abdominal	torso	PART_OF
appliance	gadget	SYN
ethics	philosophy	HYPER
butterball	fatso	SYN
organisation	authorities	PART_OF
impermanent	permanent	ANT
scoop	backhoe	PART_OF
judge	wake	RANDOM
artist	study	RANDOM
secularisation	secularization	SYN
arrange	agree	HYPER
largeness	smallness	ANT
addition	subtraction	ANT
calm	pain	RANDOM
watt	horsepower	PART_OF
approach	punishment	RANDOM
binaural	monaural	ANT
opening	lithosphere	PART_OF
anticlimactic	climactic	ANT
emptor	vendee	SYN
homoeroticism	homosexuality	SYN
baby	straight	RANDOM
verb	verb	PART_OF
clamouring	utterance	HYPER
joint	fix	RANDOM
punctuation	orthography	PART_OF
changeover	transition	SYN
scam	swindle	SYN
draftee	volunteer	ANT
acknowledgment	notation	HYPER
suffering	wretchedness	HYPER
suit	businessperson	HYPER
discourage	warn	SYN
claw	crustacean	PART_OF
spray	jet	HYPER
cross	hybridization	SYN
choke	aircraft	PART_OF
cab	taxicab	SYN
ringing	sonority	SYN
conditioned	unconditioned	ANT
key	hour	RANDOM
doggerel	jingle	SYN
acidity	sourness	SYN
receptive	unreceptive	ANT
biome	community	HYPER
hollowness	solidity	ANT
lucky	unlucky	ANT
stylus	phonograph	PART_OF
insecure	secure	ANT
peasant	labourer	HYPER
altogether	entirely	SYN
learn	wild	RANDOM
coping	edifice	PART_OF
tincture	colour	HYPER
aroused	stirred	SYN
chicken	shop	RANDOM
expense	spending	HYPER
inpatient	outpatient	ANT
mattress	bedchamber	PART_OF
thwart	dinghy	PART_OF
hopeful	promising	SYN
jail	cube	RANDOM
parent	fill	RANDOM
centimetre	m	PART_OF
mark	create	RANDOM
life	beam	RANDOM
insufficient	sufficient	ANT
bike	service	RANDOM
pledge	plight	SYN
sector	economy	PART_OF
portion	repast	PART_OF
thrashing	whacking	SYN
affinity	consanguinity	ANT
shush	subdue	HYPER
impulsive	whimsical	SYN
prawn	shrimp	PART_OF
vanish	advance	HYPER
soma	someone	PART_OF
music	vehicle	RANDOM
aisle	metal	RANDOM
episode	flick	PART_OF
offstage	onstage	ANT
distributary	tributary	ANT
effacement	pregnancy	PART_OF
chest	real	RANDOM
usefulness	uselessness	ANT
tuatara	reptilian	HYPER
related	unrelated	ANT
socket	os	PART_OF
civilization	sharp	RANDOM
faithful	unfaithful	ANT
china	group	RANDOM
assembling	collecting	SYN
dusk	evening	PART_OF
rein	harness	PART_OF
move	room	RANDOM
profound	superficial	ANT
acceptance	disposition	HYPER
judiciary	authorities	PART_OF
rinsing	washing	PART_OF
life	begin	RANDOM
nonproliferation	proliferation	ANT
dm	dam	PART_OF
independence	movement	RANDOM
pubis	hip	PART_OF
nanometer	micron	PART_OF
attentiveness	inattentiveness	ANT
marijuana	hemp	PART_OF
balance	sell	RANDOM
fidelity	infidelity	ANT
rapt	rhapsodic	SYN
brier	erica	HYPER
assigned	unassigned	ANT
dying	lifespan	PART_OF
sextant	circumference	PART_OF
kurus	lira	PART_OF
noise	television	RANDOM
ball	stool	RANDOM
judiciary	regime	PART_OF
favoritism	favouritism	SYN
grinder	hoagy	SYN
cubic	planar	ANT
go	decide	HYPER
pommel	steel	PART_OF
devise	cause	HYPER
old	clean	RANDOM
cushioning	artifact	HYPER
honesty	cash	RANDOM
ireland	professor	RANDOM
profane	violate	SYN
believably	unbelievably	ANT
christian	steal	RANDOM
imprinting	acquisition	HYPER
cockpit	aircraft	PART_OF
decent	decently	SYN
renovation	improvement	HYPER
strap	chemise	PART_OF
comparably	incomparably	ANT
popularisation	degradation	HYPER
spanking	correction	HYPER
affirmation	reversal	ANT
bias	lot	RANDOM
fraternal	identical	ANT
easy	well-off	SYN
contralateral	ipsilateral	ANT
radish	radish	PART_OF
captor	liberator	ANT
smiler	homo	PART_OF
eatery	edifice	HYPER
100th	hundredth	SYN
term	proposition	PART_OF
ice	unhappy	RANDOM
muscadine	muscadine	PART_OF
declarative	interrogative	ANT
autologous	homologous	ANT
pretentious	unpretentious	ANT
ceremoniously	unceremoniously	ANT
gleam	happening	HYPER
portion	unit	PART_OF
sewerage	infrastructure	PART_OF
mailer	advert	HYPER
knight	advance	HYPER
inward	outward	ANT
govern	decide	HYPER
rightness	wrongness	ANT
overhead	liner	PART_OF
oculus	caput	PART_OF
persevere	preserve	HYPER
purl	embellish	HYPER
quarter	period	HYPER
anger	nothing	RANDOM
rift	rupture	SYN
parent	kindness	RANDOM
rebury	displace	HYPER
baby	pin	RANDOM
hymn	glorify	HYPER
crack	snap	SYN
artificial	unreal	SYN
reissue	transfer	HYPER
runway	railway	PART_OF
solidification	plastination	PART_OF
amnesiac	someone	HYPER
apartment	wrong	RANDOM
reliability	unreliability	ANT
hideous	horrid	SYN
cannabis	jar	RANDOM
enlarge	magnify	SYN
confined	invasive	ANT
branch	mail	RANDOM
ireland	moon	RANDOM
consummation	ending	HYPER
disgusting	distasteful	SYN
illicit	licit	ANT
salvation	delivery	HYPER
decisive	indecisive	ANT
anhydrous	hydrous	ANT
intellect	someone	HYPER
fawn	grovel	SYN
intemperance	temperance	ANT
agitate	invite	HYPER
prideful	triumphal	SYN
unseasoned	untested	SYN
overstatement	understatement	ANT
noisily	quietly	ANT
imitation	simulated	SYN
tip	cone	PART_OF
bathroom	music	RANDOM
impropriety	propriety	ANT
poor	rich	ANT
rachis	stalk	HYPER
blinding	dazzling	SYN
magazine	depositary	HYPER
runway	airfield	PART_OF
intensifier	modifier	HYPER
shank	spatula	PART_OF
menopause	maturity	PART_OF
bolero	terpsichore	HYPER
asphyxiation	ending	HYPER
effectually	ineffectually	ANT
anchorage	haven	PART_OF
counteract	subvert	SYN
fixings	nutrient	HYPER
scratch	delete	HYPER
scattering	activity	HYPER
ascend	faith	RANDOM
defect	mar	SYN
hypertension	hypotension	ANT
extramural	intramural	ANT
decelerate	diminish	HYPER
mass	mess	SYN
farrago	hodgepodge	SYN
certified	uncertified	ANT
hertz	megahertz	PART_OF
chip	fan	RANDOM
man	saucepan	RANDOM
choroid	oculus	PART_OF
quarter	upper	PART_OF
mouth	remove	RANDOM
visage	homo	PART_OF
familial	genetic	SYN
gadget	instrumentality	HYPER
eddo	taro	PART_OF
affection	stick	RANDOM
working	artifact	HYPER
soak	sop	SYN
life	subject	RANDOM
diachronic	synchronic	ANT
china	pet	RANDOM
objectively	subjectively	ANT
defeatist	skeptic	HYPER
grille	auto	PART_OF
dusk	eventide	PART_OF
oaf	somebody	HYPER
hundredweight	tonne	PART_OF
immersion	occultation	PART_OF
lookout	artefact	HYPER
distribution	marketing	PART_OF
attrition	exertion	HYPER
fewer	more	ANT
bud	sprout	HYPER
news	pot	RANDOM
primitive	someone	HYPER
anisotropic	isotropic	ANT
earthbound	prosaic	SYN
capitalism	socialism	ANT
interdict	edict	HYPER
beak	please	RANDOM
debut	introduction	SYN
hardness	softness	ANT
judgmental	nonjudgmental	ANT
morning	daytime	PART_OF
griffon	vulture	HYPER
harbor	nurse	SYN
shallot	shallot	PART_OF
wedding	ceremony	HYPER
bedroom	sink	RANDOM
steady	unsteady	ANT
confab	confer	SYN
conception	misconception	ANT
chair	separation	RANDOM
kind	ugly	RANDOM
hilt	dagger	PART_OF
circular	rotary	SYN
mahogany	sepia	SYN
ascertain	check	SYN
old	hoof	RANDOM
bathtub	habitation	PART_OF
transvestite	being	HYPER
dimmed	undimmed	ANT
prompter	assistant	HYPER
tamarindo	tamarindo	PART_OF
channel	serve	RANDOM
offing	main	PART_OF
physiognomy	homo	PART_OF
roadside	transit	PART_OF
key	arcade	PART_OF
thickness	thinness	ANT
trained	untrained	ANT
anterograde	retrograde	ANT
proboscis	mammoth	PART_OF
obliquity	maternity	PART_OF
overabundance	quantity	HYPER
centerfield	outfield	PART_OF
guarantee	endorse	HYPER
hierarchy	governance	PART_OF
armament	disarmament	ANT
font	grapheme	HYPER
blare	toot	SYN
clip	reproduction	RANDOM
hassle	scuffle	SYN
knickers	unmentionable	HYPER
running	working	SYN
economy	grouping	HYPER
balmy	loony	SYN
metaphysics	humanities	HYPER
enthralled	entranced	SYN
mix	street	RANDOM
upbringing	heritage	HYPER
box	bus	RANDOM
minister	stock	RANDOM
separatist	somebody	HYPER
conservatoire	building	HYPER
interpolation	interposition	SYN
privileged	underprivileged	ANT
banality	bromide	SYN
shank	faucet	PART_OF
pleasantness	unpleasantness	ANT
actress	spouse	RANDOM
hood	camera	PART_OF
leeward	windward	ANT
sartor	tailor	SYN
abstractly	concretely	ANT
leak	gun	RANDOM
kilohertz	megahertz	PART_OF
gunstock	battery	PART_OF
ambidextrous	left-handed	ANT
sputter	struggle	SYN
leaf	recess	RANDOM
bodily	somatic	SYN
generalist	specialist	ANT
nonsmoker	smoker	ANT
maelstrom	current	HYPER
affirmation	reversal	ANT
figure	ground	ANT
marketer	vender	SYN
case	television	RANDOM
popularity	unpopularity	ANT
big	common	RANDOM
art	pride	RANDOM
pliant	waxy	SYN
landing	stairway	PART_OF
manufacture	question	RANDOM
artist	suffer	RANDOM
chuck	lathe	PART_OF
bumpkin	hayseed	SYN
roughneck	wrongdoer	HYPER
decency	indecency	ANT
justiciary	adjudicator	HYPER
adjacency	contiguity	SYN
lung	courage	RANDOM
pass	spit	RANDOM
haggard	pinched	SYN
undaunted	unshaken	SYN
unwillingness	willingness	ANT
amends	restitution	SYN
strengthening	weakening	ANT
transept	church	PART_OF
rattle	rattlesnake	PART_OF
cathedra	cathedral	PART_OF
inferiority	superiority	ANT
oppress	nettle	HYPER
meat	solid	RANDOM
dismissal	liberation	SYN
retail	wholesale	ANT
biggin	headdress	HYPER
fitness	competence	HYPER
ounce	lb	PART_OF
fresher	undergrad	HYPER
selfishness	unselfishness	ANT
can	privy	PART_OF
apron	theatre	PART_OF
mesmerised	spellbound	SYN
bathroom	descend	RANDOM
secluded	sequestered	SYN
bombsight	sights	HYPER
flash	gaudy	SYN
counterbalance	differ	HYPER
contents	publication	PART_OF
contraction	expansion	ANT
thus	thusly	SYN
provocateur	agent	HYPER
convenience	gadget	SYN
closeness	nearness	SYN
parole	release	HYPER
stack	pose	HYPER
effective	effectual	SYN
angstrom	micrometer	PART_OF
nettlesome	tetchy	SYN
maximally	minimally	ANT
ethics	morals	SYN
belt	know	RANDOM
breadfruit	breadfruit	PART_OF
fertile	sterile	ANT
spindle	portion	HYPER
placard	poster	SYN
movement	offspring	RANDOM
magneto	ignition	PART_OF
male	touch	RANDOM
injure	arrive	RANDOM
rotor	stator	ANT
tilling	agriculture	PART_OF
centavo	sucre	PART_OF
backrest	motorcar	PART_OF
arrest	halt	SYN
fiber	someone	PART_OF
sublimate	sublime	SYN
implausible	plausible	ANT
pace	furlong	PART_OF
thrifty	wasteful	ANT
traversal	skiing	PART_OF
mental	physical	ANT
equity	inequity	ANT
mind	rare	RANDOM
developing	development	SYN
astray	wide	SYN
buns	torso	PART_OF
distribute	bare	HYPER
delirious	excited	SYN
order	sick	RANDOM
dead	living	ANT
sunburn	erythema	HYPER
liquid	gate	RANDOM
gallant	swell	SYN
sweep	tangle	SYN
brain	movie	RANDOM
criminalisation	governance	HYPER
gilded	golden	SYN
knowledgeable	lettered	SYN
male	stone	RANDOM
circle	clean	RANDOM
leg	movie	RANDOM
criticism	critique	SYN
movement	adult	RANDOM
perusal	studying	SYN
analytic	synthetic	ANT
monotheism	polytheism	ANT
powered	unpowered	ANT
digestion	learning	HYPER
neutrino	lepton	HYPER
field	arena	PART_OF
engagement	warfare	PART_OF
rotor	turbine	PART_OF
bright	wife	RANDOM
sheathed	unsheathed	ANT
boeuf	kine	PART_OF
estimate	guess	SYN
greater	lesser	ANT
druthers	alternative	HYPER
sixties	age	PART_OF
gluteus	torso	PART_OF
ending	narration	PART_OF
congruent	incongruent	ANT
tracer	officer	HYPER
synapse	nerve	PART_OF
basting	roasting	PART_OF
supercilium	caput	PART_OF
direct	inverse	ANT
convene	convoke	SYN
local	national	ANT
highland	lowland	ANT
epilogue	writing	PART_OF
acceptably	tolerably	SYN
bolt	head	RANDOM
imperishable	perishable	ANT
cheat	crop	RANDOM
impermanence	permanence	ANT
stator	turbine	PART_OF
cell	weed	RANDOM
advance	contaminate	RANDOM
acceptance	approving	HYPER
spattering	sputtering	SYN
disruption	perturbation	SYN
core	pith	SYN
teeter	playground	PART_OF
dredge	dredger	PART_OF
insubstantial	substantial	ANT
shaft	pillar	PART_OF
pain	man	RANDOM
soundboard	piano	PART_OF
project	task	SYN
mid-seventies	years	PART_OF
centralise	concentrate	SYN
affirmative	negative	ANT
pedal	wave	RANDOM
escort	preserver	HYPER
tiro	tyro	SYN
scorch	singe	SYN
beautiful	seat	RANDOM
bar	minute	RANDOM
prospect	analyse	HYPER
expel	release	SYN
buried	unburied	ANT
monger	trader	SYN
consecration	commitment	HYPER
dissuasive	persuasive	ANT
princedom	region	HYPER
structuralism	sociology	PART_OF
channel	furniture	RANDOM
omit	eliminate	HYPER
mumbling	enunciation	HYPER
moderately	pretty	SYN
glowering	sullen	SYN
co-op	cooperative	SYN
adhesion	bond	SYN
seesaw	playground	PART_OF
belt	lazy	RANDOM
eyelash	eyelid	PART_OF
bird	pure	RANDOM
salary	payroll	PART_OF
party	answer	RANDOM
hierarchy	regime	PART_OF
lace	die	RANDOM
darn	restore	HYPER
functional	organic	ANT
mindful	unmindful	ANT
formulate	express	HYPER
general	universal	SYN
stride	walking	PART_OF
bod	soma	SYN
bonk	jazz	SYN
airplane	half	RANDOM
hierarchy	organisation	PART_OF
fixture	mend	SYN
large	free	RANDOM
blood	descent	SYN
insanity	sanity	ANT
vibrate	evoke	HYPER
benefit	friendly	RANDOM
humanist	advocate	HYPER
cent	florin	PART_OF
backside	torso	PART_OF
last	lowest	SYN
discriminate	indiscriminate	ANT
micrometer	centimeter	PART_OF
archway	building	PART_OF
ill-defined	well-defined	ANT
fox	pelt	HYPER
bird	successful	RANDOM
chop	humble	RANDOM
discouraging	encouraging	ANT
intemperate	temperate	ANT
lifestyle	way	HYPER
coursework	course	PART_OF
grid	accumulator	PART_OF
salamander	amphibian	HYPER
forearm	arm	PART_OF
herring	herring	PART_OF
cuddle	nestle	SYN
gauche	graceless	SYN
blindness	impairment	HYPER
decisiveness	indecisiveness	ANT
vestibule	edifice	PART_OF
above	below	ANT
compactness	density	SYN
america	port	RANDOM
class	service	RANDOM
disobedience	obedience	ANT
sisterhood	organization	HYPER
carriage	mechanism	HYPER
corruptible	venal	SYN
gushing	gushy	SYN
names	disparagement	HYPER
carrier	immune	HYPER
fertilizer	stuff	HYPER
soybean	soya	PART_OF
penis	hour	RANDOM
base	pipe	RANDOM
corpulent	weighty	SYN
rail	balcony	PART_OF
hockey	darling	RANDOM
taxiway	field	PART_OF
glut	provide	HYPER
draft	pulling	HYPER
hoof	ungulate	PART_OF
enamored	smitten	SYN
go	spell	SYN
ruddy	scarlet	SYN
exception	example	HYPER
railing	bannister	PART_OF
limited	special	SYN
pedal	minute	RANDOM
certification	authorization	HYPER
lard	mislead	HYPER
usher	official	HYPER
zodiac	heavens	PART_OF
link	nothing	RANDOM
abdominal	belly	PART_OF
drag	trail	SYN
impossibility	possibility	ANT
authorized	unauthorized	ANT
koala	possum	HYPER
milk	cloudy	RANDOM
meter	metric	HYPER
darn	bushel	HYPER
stimulation	stimulus	SYN
chair	pencil	RANDOM
balusters	handrail	SYN
me	nature	RANDOM
chamber	domicile	PART_OF
grading	scoring	SYN
adagio	duet	PART_OF
frolic	lark	SYN
bunco	diddle	SYN
promenade	saunter	SYN
lease	conclusion	RANDOM
comprehensible	incomprehensible	ANT
episodic	occasional	SYN
savory	unsavory	ANT
jump	leave	RANDOM
afterburner	turboprop	PART_OF
birth	exercise	RANDOM
entourage	retinue	SYN
tussle	struggle	HYPER
idleness	laziness	HYPER
belt	sweet	RANDOM
dishonest	honest	ANT
deserter	renegade	SYN
ten	tenner	SYN
attractive	unattractive	ANT
pinnacle	summit	SYN
easy	well-to-do	SYN
chocolate	member	RANDOM
purchasing	purchase	HYPER
pain	happy	RANDOM
grandeur	splendour	SYN
cellar	toe	RANDOM
oblique	perpendicular	ANT
bodice	frock	PART_OF
chafe	vex	SYN
commonplace	timeworn	SYN
adventure	fashion	RANDOM
rape	violation	SYN
maternal	paternal	ANT
origin	source	HYPER
jati	stratum	HYPER
headrest	motorcar	PART_OF
endorse	sanction	HYPER
base	head	RANDOM
competent	incompetent	ANT
tush	torso	PART_OF
casbah	kasbah	SYN
lampoon	travesty	SYN
peacefulness	calmness	HYPER
conscientious	scrupulous	SYN
reserve	stockpile	SYN
high	order	RANDOM
birthplace	cradle	SYN
bonanza	godsend	SYN
telling	weighty	SYN
nonpartisan	partisan	ANT
lyssa	rabies	SYN
rocket	projectile	PART_OF
disobedient	obedient	ANT
big	sharp	RANDOM
sertraline	antidepressant	HYPER
fatal	nonfatal	ANT
host	parasite	ANT
sideboard	dwelling	PART_OF
jimmy	pry	HYPER
fame	infamy	ANT
cockpit	racer	PART_OF
light	throw	RANDOM
acceptance	rejection	ANT
captain	patient	RANDOM
equality	inequality	ANT
grievance	complaint	HYPER
appraisal	judgment	HYPER
aggrandizement	step-up	HYPER
dial	timekeeper	PART_OF
overstatement	understatement	ANT
hemp	gallows	PART_OF
gravestone	tombstone	SYN
catalog	categorise	HYPER
trine	trinity	SYN
downpour	waterspout	SYN
fluidity	liquidity	SYN
mile	league	PART_OF
conformist	nonconformist	ANT
shot	pic	PART_OF
prosecutor	official	HYPER
action	shape	RANDOM
alert	zippy	SYN
reliable	unreliable	ANT
garnish	alter	HYPER
lens	teacher	RANDOM
mercury	friendly	RANDOM
embolism	calendar	PART_OF
fluor	fluorite	SYN
history	pale	RANDOM
bad	recycle	RANDOM
bolt	part	RANDOM
aggravation	provocation	SYN
elbow	tube	HYPER
idiosyncrasy	mannerism	SYN
feed	transfer	HYPER
multiculturalism	nationalism	ANT
affiliated	attached	SYN
thrust	motion	HYPER
lie	less	RANDOM
enchilada	sustenance	HYPER
effectuate	do	HYPER
scallop	scallop	PART_OF
dim	faint	SYN
decisiveness	indecisiveness	ANT
exile	outlander	HYPER
adequacy	inadequacy	ANT
sprint	zip	HYPER
cilantro	coriander	PART_OF
monotheistic	polytheistic	ANT
arm	sentence	RANDOM
revitalisation	revival	SYN
quay	wharf	HYPER
diurnal	nocturnal	ANT
join	unpleasant	RANDOM
impermeable	permeable	ANT
exquisite	keen	SYN
basement	race	RANDOM
jeer	jeering	SYN
porosity	solidity	ANT
ambiguously	unambiguously	ANT
observe	canvas	HYPER
hockey	grip	RANDOM
buy	tall	RANDOM
clang	clash	SYN
likely	unlikely	ANT
stave	rocker	PART_OF
shank	footwear	PART_OF
hook	plume	SYN
pompano	pompano	PART_OF
parent	clean	RANDOM
overhead	disbursement	HYPER
stair	edifice	PART_OF
intolerably	tolerably	ANT
male	bind	RANDOM
beak	spirit	RANDOM
generalship	billet	HYPER
low	ideology	RANDOM
joy	west	RANDOM
hive	apiary	PART_OF
also	besides	SYN
theogony	domain	HYPER
track	railway	PART_OF
deformity	disfigurement	SYN
aid	box	RANDOM
able	unable	ANT
cubicle	convent	PART_OF
ball	less	RANDOM
weirdness	unfamiliarity	HYPER
electrode	circuit	PART_OF
hot	solution	RANDOM
kick	gain	HYPER
itch	infection	HYPER
hundredweight	t	PART_OF
filing	storage	HYPER
calculating	shrewd	SYN
accident	teacher	RANDOM
modern	family	RANDOM
periscope	submarine	PART_OF
intestine	torso	PART_OF
carriage	lathe	PART_OF
convenience	instrumentation	HYPER
immobility	mobility	ANT
pong	smell	HYPER
beginning	origin	SYN
annex	building	PART_OF
kitten	waterfall	RANDOM
jump	space	RANDOM
h	constant	HYPER
plowed	unplowed	ANT
eyelid	optic	PART_OF
ti	shrub	HYPER
cub	rookie	SYN
umbilicus	abdomen	PART_OF
endive	endive	PART_OF
microprocessor	microcomputer	PART_OF
readjustment	accommodation	HYPER
saccharin	sweetening	HYPER
approachable	unapproachable	ANT
chard	chard	PART_OF
debilitating	invigorating	ANT
jiao	kwai	PART_OF
fortuitously	luckily	SYN
joy	season	RANDOM
induct	countenance	HYPER
roofing	building	PART_OF
dig	grasp	SYN
repetition	occurrence	HYPER
batch	pile	SYN
ink	fabric	RANDOM
sleeper	railway	PART_OF
landing	seafront	PART_OF
dag	kilo	PART_OF
scientific	unscientific	ANT
instep	stocking	PART_OF
remedy	intervention	PART_OF
miss	shoe	RANDOM
endocrine	exocrine	ANT
variety	species	PART_OF
eldest	relative	HYPER
defendant	plaintiff	ANT
conventional	unconventional	ANT
nanosecond	microsecond	PART_OF
actor	stage	RANDOM
eats	nutrient	HYPER
armrest	motorcar	PART_OF
dramatic	undramatic	ANT
criminalisation	decriminalisation	ANT
box	sun	RANDOM
japan	cool	RANDOM
splendor	splendour	SYN
eyed	eyeless	ANT
human	stand	RANDOM
7th	seventh	SYN
rotor	trolleybus	PART_OF
prong	buckle	PART_OF
amend	remedy	SYN
technocrat	somebody	HYPER
tentacle	outgrowth	HYPER
skim	skitter	SYN
steerage	sailing	PART_OF
bench	squad	PART_OF
bellybutton	torso	PART_OF
beneficent	maleficent	ANT
toothed	toothless	ANT
potty	lav	PART_OF
back	tan	RANDOM
hop	sink	RANDOM
busy	member	RANDOM
nation	wagon	RANDOM
excitable	irritable	SYN
mark	wild	RANDOM
clock	young	RANDOM
affluent	feeder	SYN
kid	word	RANDOM
firewall	actuation	HYPER
collar	cop	SYN
affected	stirred	SYN
big	stone	RANDOM
disablement	unfitness	HYPER
1000	thou	SYN
class	lover	RANDOM
cental	kiloton	PART_OF
location	studio	ANT
mid-sixties	age	PART_OF
hardball	softball	ANT
curious	peculiar	SYN
heterosexual	back	RANDOM
clime	status	HYPER
matter	fact	RANDOM
visa	authorise	HYPER
acquittal	conviction	ANT
goad	instrumentality	HYPER
angelic	cherubic	SYN
insensitive	sensitive	ANT
rocker	cradle	PART_OF
paper	hear	RANDOM
buffer	locomotive	PART_OF
timing	regulating	HYPER
chromosome	nucleus	PART_OF
murder	cloth	RANDOM
augmentation	step-up	HYPER
repellant	repellent	SYN
forge	furnace	HYPER
balustrade	balcony	PART_OF
exterior	bound	HYPER
ink	bounce	RANDOM
heretofore	hitherto	SYN
modest	pocket-sized	SYN
sundown	evening	PART_OF
arbitrate	intermediate	SYN
dl	l	PART_OF
stretcher	building	PART_OF
immeasurably	measurably	ANT
block	motorboat	PART_OF
equestrian	traveller	HYPER
quarter-century	century	PART_OF
reburial	burying	HYPER
retina	optic	PART_OF
idle	prejudice	RANDOM
lahar	slide	HYPER
involuntary	voluntary	ANT
legume	legume	PART_OF
dramatise	embellish	SYN
fellow	dyad	PART_OF
fin	auto	PART_OF
corset	foundation	HYPER
dissent	resist	SYN
house	stop	RANDOM
maximization	minimization	ANT
cannon	bomber	PART_OF
metaphase	meiosis	PART_OF
chip	use	RANDOM
goon	tough	SYN
bad	spirit	RANDOM
lath	lattice	PART_OF
junior	senior	ANT
hassle	provoke	SYN
rancour	resentment	SYN
broad	wide	SYN
cwt	kiloton	PART_OF
atmosphere	war	RANDOM
sense	meaning	HYPER
mammal	get	RANDOM
declension	decline	SYN
trotter	hog	PART_OF
impertinent	orthogonal	SYN
action	level	RANDOM
transfer	transpose	SYN
ocular	binoculars	PART_OF
lat	dorsum	PART_OF
bluebell	campanula	HYPER
box	run	RANDOM
extension	filename	PART_OF
classification	declassification	ANT
gainful	paying	SYN
availability	unavailability	ANT
high-rise	low-rise	ANT
coriander	coriander	PART_OF
esoteric	exoteric	ANT
whip	worst	SYN
exclaim	verbalize	HYPER
hamburger	burger	PART_OF
flint	obdurate	SYN
delineated	represented	SYN
jeremiad	objection	HYPER
youngster	someone	HYPER
cannabis	sex	RANDOM
functional	nonfunctional	ANT
landing	haven	PART_OF
heist	robbery	HYPER
quicken	arouse	HYPER
grate	grating	SYN
brain	island	RANDOM
apple	wife	RANDOM
contend	contest	SYN
lecture	course	PART_OF
bedroom	number	RANDOM
bowel	abdomen	PART_OF
hassle	rile	HYPER
repair	reparation	SYN
glazer	glazier	SYN
airship	aircraft	HYPER
dike	lesbian	HYPER
cytokinesis	process	HYPER
mark	hall	RANDOM
tiffin	nutrition	HYPER
circlet	decoration	HYPER
mean	mistake	RANDOM
amalgamate	coalesced	SYN
helpless	incapacitated	SYN
midsection	region	HYPER
billow	inflate	SYN
botch	fluff	SYN
generosity	stinginess	ANT
blue	train	RANDOM
quantitative	syllabic	ANT
co-author	author	HYPER
irrelevant	relevant	ANT
lady	ideology	RANDOM
hardware	software	ANT
recoup	recuperate	SYN
agreement	cool	RANDOM
lock	pattern	RANDOM
cranium	caput	PART_OF
conservative	liberal	ANT
helm	tug	PART_OF
ireland	drama	RANDOM
steed	warhorse	HYPER
hot	hero	RANDOM
echo	recall	SYN
rupture	injury	HYPER
buildup	accretion	HYPER
rebuff	offence	HYPER
echo	reverberate	SYN
continue	preserve	SYN
afraid	unafraid	ANT
dejection	feces	SYN
steering	sailing	PART_OF
masses	multitude	SYN
pommel	hilt	PART_OF
care	word	RANDOM
avocado	avocado	PART_OF
map	season	RANDOM
bypass	circuit	PART_OF
cryptanalysis	cryptology	SYN
irreplaceable	replaceable	ANT
inspiration	respiration	PART_OF
selection	salmagundi	HYPER
tit	mamma	PART_OF
late	previous	SYN
offer	whirl	SYN
enlightened	unenlightened	ANT
movement	unpleasant	RANDOM
lung	mood	RANDOM
saddle	dorsum	PART_OF
ingress	eclipse	PART_OF
botanic	botanical	SYN
avo	pataca	PART_OF
commode	domicile	PART_OF
boyfriend	dry	RANDOM
flint	flinty	SYN
poppet	motorboat	PART_OF
account	residence	RANDOM
baptized	unbaptized	ANT
hinge	auto	PART_OF
muffler	exhaust	PART_OF
cocoanut	coco	PART_OF
boil	destroy	RANDOM
sower	creator	HYPER
pale	close	RANDOM
specious	spurious	SYN
china	dress	RANDOM
brown	dark-brown	SYN
knowable	unknowable	ANT
linear	planar	ANT
kingfish	mackerel	HYPER
indenture	understanding	HYPER
microgram	milligram	PART_OF
lazy	committee	RANDOM
oxaloacetate	compound	HYPER
lychee	litchi	PART_OF
orange	residence	RANDOM
fair	foul	ANT
wish	desire	HYPER
paisa	taka	PART_OF
livable	unlivable	ANT
effectively	ineffectively	ANT
night	dirty	RANDOM
asper	kurus	PART_OF
captor	liberator	ANT
throb	tremble	HYPER
note	cave	RANDOM
keystone	aqueduct	PART_OF
blade	moon	RANDOM
inexorable	relentless	SYN
bright	math	RANDOM
bum	rotter	SYN
appendix	cecum	PART_OF
intransitive	transitive	ANT
gunstock	handgun	PART_OF
recast	depute	HYPER
bright	pack	RANDOM
clergy	laity	ANT
phalanx	vertebrate	PART_OF
admire	noise	RANDOM
homeless	poor	HYPER
make	hall	RANDOM
atypically	typically	ANT
antenna	receiver	PART_OF
designation	find	HYPER
dock	haven	PART_OF
immortality	mortality	ANT
cuticle	mollusc	PART_OF
becoming	decent	SYN
irrelevance	relevance	ANT
committed	uncommitted	ANT
bowl	bowls	PART_OF
squeaker	unit	HYPER
jab	stab	SYN
effacement	labour	PART_OF
decree	fiat	SYN
internationalism	nationalism	ANT
acid	virulent	SYN
land	law	RANDOM
father-in-law	relative	HYPER
bracing	framework	PART_OF
butter	traffic	RANDOM
interlude	intermezzo	SYN
bone	service	RANDOM
hole	traffic	RANDOM
chopper	cleaver	SYN
closet	rubbish	RANDOM
admissible	inadmissible	ANT
thane	nobleman	HYPER
offspring	quit	RANDOM
balance	poise	SYN
aid	bush	RANDOM
derriere	torso	PART_OF
booster	infrastructure	PART_OF
dishonor	honor	ANT
convolution	cerebrum	PART_OF
lyric	vocal	PART_OF
blood	escape	RANDOM
recruiter	provider	HYPER
controlled	uncontrolled	ANT
love	idol	RANDOM
incline	lean	SYN
exact	inexact	ANT
acutely	chronically	ANT
dozens	tons	SYN
imperfectly	perfectly	ANT
intercalation	calendar	PART_OF
braggart	crowing	SYN
fondness	feeling	HYPER
kitten	trade	RANDOM
credit	pic	PART_OF
impiety	piety	ANT
glassy	vitreous	SYN
import	impart	HYPER
promptly	pronto	SYN
terrible	unspeakable	SYN
cuff	garment	PART_OF
kind	government	RANDOM
loser	winner	ANT
hookup	system	HYPER
libidinous	lustful	SYN
offspring	galaxy	RANDOM
facility	readiness	SYN
knowingly	unknowingly	ANT
hymen	vagina	PART_OF
sunbeam	ray	HYPER
breast	poulet	PART_OF
milk	hoof	RANDOM
dementia	insanity	HYPER
concerned	unconcerned	ANT
larceny	thieving	SYN
animal	toe	RANDOM
brother	sister	ANT
maxi	mini	ANT
apron	airfield	PART_OF
waterproof	artifact	HYPER
flurry	stir	SYN
burlesque	imitate	HYPER
evoke	suggest	SYN
nanotechnology	field	HYPER
scruple	contemplate	HYPER
patch	package	HYPER
skullcap	skull	PART_OF
actress	jar	RANDOM
katzenjammer	status	HYPER
forgettable	unforgettable	ANT
pad	slog	SYN
involuntarily	voluntarily	ANT
blow	sentence	RANDOM
graze	ply	HYPER
dun	fawn	SYN
pound	cwt	PART_OF
cowl	motorcar	PART_OF
way	infrastructure	PART_OF
herbivorous	omnivorous	ANT
earned	unearned	ANT
male	gate	RANDOM
add	fabric	RANDOM
beef	demand	RANDOM
ace	super	SYN
penis	pagan	RANDOM
demote	appoint	HYPER
accessibility	inaccessibility	ANT
crest	blazon	PART_OF
palm	manus	PART_OF
legato	staccato	ANT
market	lace	RANDOM
caput	creature	PART_OF
appropriate	inappropriate	ANT
molt	shed	SYN
fiddle	modify	HYPER
interchange	transaction	HYPER
sainthood	grouping	HYPER
print	accessibility	HYPER
bill	end	RANDOM
bark	marry	RANDOM
drawer	dresser	PART_OF
tenor	musician	HYPER
meter	dam	PART_OF
greengrocer	merchant	HYPER
focused	unfocused	ANT
impatience	patience	ANT
shank	pushcart	PART_OF
tapper	somebody	HYPER
bowl	go	HYPER
lend	alter	HYPER
potty	can	PART_OF
chin	homo	PART_OF
coloured	one-sided	SYN
homogeneous	homogenous	SYN
bathtub	dwelling	PART_OF
marketplace	outlet	HYPER
classicist	romanticist	ANT
leaf	solution	RANDOM
bowel	torso	PART_OF
beseeching	imperative	ANT
deciliter	l	PART_OF
awful	frightening	SYN
way	transit	PART_OF
total	modify	HYPER
jack	jackfruit	PART_OF
addressed	unaddressed	ANT
blue-collar	white-collar	ANT
strap	suspender	PART_OF
e	grapheme	HYPER
gunboat	watercraft	HYPER
embankment	mound	HYPER
cure	intervention	PART_OF
amateur	athlete	HYPER
advocate	preach	SYN
news	lobby	RANDOM
trigon	trilateral	SYN
ringlet	hairstyle	PART_OF
mountain	party	RANDOM
powerhouse	infrastructure	PART_OF
turbojet	turbojet	PART_OF
jab	gesture	HYPER
line	integrity	RANDOM
balance	imbalance	ANT
nectarine	nectarine	PART_OF
marriage	count	RANDOM
loose	asia	RANDOM
butter	lady	RANDOM
midway	carnival	PART_OF
changeling	cretin	SYN
cancer	lightweight	RANDOM
receive	perceive	HYPER
athlete	charge	RANDOM
primrose	primula	SYN
preference	asset	HYPER
insolvent	solvent	ANT
pufferfish	puffer	PART_OF
engulf	steep	SYN
corolla	bloom	PART_OF
neck	artefact	HYPER
artisan	craftsman	SYN
sixteenth	position	HYPER
lodging	artifact	HYPER
hypnosis	condition	HYPER
inalienable	unalienable	SYN
deserter	quitter	HYPER
make	flight	RANDOM
oregano	marjoram	PART_OF
advert	associate	HYPER
seamy	squalid	SYN
chapter	finish	RANDOM
capacity	incapacity	ANT
cling	hang	SYN
swerve	trend	SYN
acknowledge	admit	SYN
hook	snare	SYN
pel	raster	PART_OF
bottom-up	top-down	ANT
cylinder	compressor	PART_OF
auspicious	inauspicious	ANT
demented	disturbed	SYN
piss	urinate	SYN
sweatshirt	sweats	PART_OF
envelope	balloon	PART_OF
words	dialogue	PART_OF
portion	earnings	PART_OF
infield	outfield	ANT
sperm	ejaculate	PART_OF
nation	filthy	RANDOM
chain	ingredient	RANDOM
prodding	spur	SYN
responsive	unresponsive	ANT
fart	farting	SYN
third	motorcar	PART_OF
calm	fish	RANDOM
nucleus	library	RANDOM
communicable	transmissible	SYN
monster	anomaly	HYPER
oilfield	field	HYPER
account	machine	RANDOM
perch	mile	PART_OF
unwilling	willing	ANT
radius	arm	PART_OF
imitation	impersonation	SYN
chapter	rule	RANDOM
absurdity	trait	HYPER
constitutionally	unconstitutionally	ANT
croon	utter	HYPER
criminalisation	decriminalisation	ANT
fontanelle	minor	PART_OF
catch	make	RANDOM
hitman	torpedo	SYN
foundation	structure	PART_OF
concentric	eccentric	ANT
appearance	disappearance	ANT
scuttle	skitter	SYN
distressing	troubling	SYN
blooper	blunder	SYN
suspect	imagine	HYPER
deadening	tiresome	SYN
link	disk	RANDOM
object	creation	RANDOM
profession	avowal	HYPER
knowledge	money	RANDOM
human	produce	RANDOM
homosexual	praise	RANDOM
verge	wand	SYN
collectivism	orientation	HYPER
disabling	enabling	ANT
nadir	firmament	PART_OF
photomontage	ikon	HYPER
railing	handrail	PART_OF
fontanelle	nestling	PART_OF
topping	repast	PART_OF
cardamom	cardamom	PART_OF
bombard	knock	HYPER
hood	auto	PART_OF
selfish	unselfish	ANT
mississippi	fight	RANDOM
dingy	dreary	SYN
wick	candle	PART_OF
illness	correct	RANDOM
gonzo	outre	SYN
forte	steel	PART_OF
predate	ingest	HYPER
broadly	narrowly	ANT
jaw	os	HYPER
talent	aptitude	HYPER
chlorate	salt	HYPER
femur	thigh	PART_OF
alb	robe	HYPER
attentiveness	inattentiveness	ANT
prevalent	rife	SYN
wanton	romance	HYPER
imprudence	prudence	ANT
badness	goodness	ANT
application	activity	HYPER
loud	coat	RANDOM
apotheosis	nonesuch	SYN
marriage	art	RANDOM
waist	clubhead	PART_OF
collier	laborer	HYPER
credibly	incredibly	ANT
bright	scissor	RANDOM
sleepiness	wakefulness	ANT
class	misunderstand	RANDOM
annulus	skirt	SYN
edging	carpet	PART_OF
midterm	gestation	PART_OF
mix	energy	RANDOM
mullion	edifice	PART_OF
facilitator	helper	HYPER
phalanx	dactyl	PART_OF
list	relation	HYPER
perturb	affect	HYPER
gladiolus	breastbone	PART_OF
kennel	outbuilding	HYPER
persecute	nettle	HYPER
offer	wage	HYPER
mismatch	equivalent	HYPER
assortment	classification	SYN
distal	proximal	ANT
ancestor	descendant	ANT
beneficiary	receiver	HYPER
chain	side	RANDOM
anticholinergic	cholinergic	ANT
sundown	eventide	PART_OF
camp	shelter	HYPER
pea	vegetable	HYPER
ocular	sights	PART_OF
paper	hole	RANDOM
teenage	teenaged	SYN
explosion	expression	HYPER
genuine	literal	SYN
tied	untied	ANT
no	yes	ANT
bearer	pallbearer	SYN
transition	alteration	HYPER
machine	horn	RANDOM
mincing	twee	SYN
diction	phrasing	SYN
appropriateness	inappropriateness	ANT
bilk	spoil	SYN
shaft	edifice	PART_OF
demerit	merit	ANT
pounding	throb	SYN
kindling	lighting	SYN
dismissal	sack	SYN
pharynx	neck	PART_OF
milestone	occurrence	HYPER
checkerboard	draughts	PART_OF
sector	field	PART_OF
busybody	meddler	HYPER
dancer	being	HYPER
penis	pot	RANDOM
minimise	understate	SYN
scapula	shoulder	PART_OF
captain	wet	RANDOM
grate	furnace	PART_OF
smother	fume	HYPER
starless	starry	ANT
testicle	testis	SYN
mate	instrument	RANDOM
act	vehicle	RANDOM
baseball	head	RANDOM
jot	jotting	SYN
high	zero	RANDOM
paved	unpaved	ANT
basic	introductory	SYN
adaptive	maladaptive	ANT
instability	stability	ANT
ban	banish	SYN
chives	chive	PART_OF
relishing	intake	HYPER
prognosis	prospect	SYN
kind	song	RANDOM
basketball	pet	RANDOM
audacious	dauntless	SYN
buffet	nutrition	HYPER
lovable	loveable	SYN
distraction	amusement	HYPER
bourgeois	burgher	SYN
blue	something	RANDOM
despatch	expedition	SYN
ditto	iterate	HYPER
appease	stay	SYN
desirable	undesirable	ANT
equality	inequality	ANT
paragraph	publication	PART_OF
exon	intron	ANT
trigger	instrumentality	HYPER
summoning	dispossession	PART_OF
eyelid	oculus	PART_OF
sleazy	squalid	SYN
monotonic	monotonous	SYN
vane	helicopter	PART_OF
bill	full	RANDOM
becoming	seemly	SYN
coming	timing	HYPER
aerated	charged	SYN
lower	communication	RANDOM
section	platoon	PART_OF
beginning	ending	ANT
dehydrated	dried	SYN
voucher	admirer	HYPER
turbofan	jet	HYPER
bole	pigment	HYPER
hilt	sticker	PART_OF
dirham	dinar	PART_OF
mate	hat	RANDOM
caul	uterus	PART_OF
lose	farm	RANDOM
partisan	booster	HYPER
servitude	thrall	HYPER
marabou	marabout	PART_OF
joyless	joyous	ANT
love	individual	RANDOM
metallic	nonmetallic	ANT
valve	brass	PART_OF
waning	waxing	ANT
undertow	stream	HYPER
taxiway	transit	PART_OF
cannon	quadruped	PART_OF
chatty	garrulous	SYN
way	unit	HYPER
notch	range	PART_OF
balance	fact	RANDOM
affirmative	negative	ANT
sprawling	straggly	SYN
likelihood	unlikelihood	ANT
airplane	theory	RANDOM
energise	excite	SYN
rick	cumulus	HYPER
exigency	pinch	SYN
throne	lav	PART_OF
bow	unpleasant	RANDOM
brightness	dullness	ANT
decidedly	unquestionably	SYN
centime	dinar	PART_OF
little	demand	RANDOM
meditative	pensive	SYN
bed	ax	RANDOM
abdomen	stomach	PART_OF
interference	noninterference	ANT
charm	flavour	HYPER
mention	reference	SYN
closet	teach	RANDOM
black	day	RANDOM
inhabitant	being	HYPER
lost	won	ANT
big	trunk	RANDOM
knickerbockers	knickers	SYN
lawful	rightful	SYN
moderation	temperance	SYN
lose	common	RANDOM
fingerboard	banjo	PART_OF
molting	moult	SYN
art	walk	RANDOM
inoculate	modify	HYPER
cutter	feeder	HYPER
execute	slay	HYPER
beard	whiskers	SYN
mesic	xeric	ANT
fry	nestling	SYN
mercury	student	RANDOM
nettlesome	vexatious	SYN
humpbacked	hunchbacked	SYN
chain	marriage	RANDOM
waterway	artifact	HYPER
fold	enclosure	HYPER
reclamation	reformation	SYN
stamen	angiosperm	PART_OF
inshore	offshore	ANT
dugout	ballpark	PART_OF
cypher	zero	SYN
nuke	assail	HYPER
tub	habitation	PART_OF
beautiful	record	RANDOM
dying	life-time	PART_OF
language	seal	RANDOM
objective	subjective	ANT
remission	penance	PART_OF
dioecious	monoecious	ANT
irreverence	reverence	ANT
shellfish	mollusc	PART_OF
contentment	discontentment	ANT
humility	busy	RANDOM
ignorance	frame	RANDOM
theogony	field	HYPER
meddling	officious	SYN
lobby	take	RANDOM
secrecy	trait	HYPER
flexibility	inflexibility	ANT
premeditation	provision	HYPER
hopefully	hopelessly	ANT
impolite	polite	ANT
me	noise	RANDOM
funded	unfunded	ANT
blurb	endorsement	SYN
boy	ocean	RANDOM
marriage	arrive	RANDOM
act	snow	RANDOM
fickle	quicksilver	SYN
goad	harry	HYPER
porosity	solidity	ANT
dejected	elated	ANT
preparation	resolution	ANT
vestry	church	PART_OF
locator	surveyor	HYPER
finitely	infinitely	ANT
introduction	recital	PART_OF
litre	hl	PART_OF
carom	billiards	PART_OF
adult	night	RANDOM
riptide	tide	PART_OF
contested	uncontested	ANT
fin	motorcar	PART_OF
crayfish	crayfish	PART_OF
travail	gestation	PART_OF
driver	programme	HYPER
channel	active	RANDOM
immoderate	moderate	ANT
cliff	drop-off	SYN
gluey	pasty	SYN
bloodline	descent	SYN
mercury	have	RANDOM
berate	rebuke	SYN
invert	grade	HYPER
improved	unimproved	ANT
contour	delineate	HYPER
motif	theme	SYN
holy	unholy	ANT
movie	dictionary	RANDOM
disdainful	prideful	SYN
arbitrator	authority	HYPER
grate	range	PART_OF
hindering	obstructive	SYN
intake	respiration	PART_OF
caecum	cecum	SYN
lawless	outlaw	SYN
cod	pod	SYN
corona	nimbus	PART_OF
gloat	gloating	SYN
assemble	strong	RANDOM
nadir	heavens	PART_OF
quail	quail	PART_OF
shaving	cleanup	HYPER
jugular	cervix	PART_OF
dysphoria	discontentment	HYPER
pinger	submarine	PART_OF
cockle	ruffle	SYN
case	fail	RANDOM
air	tan	RANDOM
begin	correct	RANDOM
gloaming	nightfall	SYN
bracket	sort	HYPER
tarsus	vertebrate	PART_OF
ocean	close	RANDOM
claw	grapple	PART_OF
lie	sink	RANDOM
rheumatism	malady	HYPER
rapid	waterway	HYPER
existence	nonexistence	ANT
ice	prosecution	RANDOM
jolly	passably	SYN
parterre	theater	PART_OF
precede	premise	SYN
cherry	cherry	PART_OF
crimp	flexure	SYN
line	window	RANDOM
porthole	aeroplane	PART_OF
reacquaint	familiarise	HYPER
harassed	harried	SYN
heartbeat	occurrence	HYPER
sewer	infrastructure	PART_OF
failing	flunk	SYN
repress	subdue	HYPER
air	reward	RANDOM
caption	flick	PART_OF
bit	pencil	RANDOM
jujube	jujube	PART_OF
clean	fireplace	RANDOM
shrine	surround	HYPER
fixer	compound	HYPER
model	simulate	HYPER
displeased	pleased	ANT
landscaping	gardening	HYPER
ketchup	condiment	HYPER
acclimatise	acclimatize	SYN
covetous	prehensile	SYN
halter	gallows	PART_OF
frantically	madly	SYN
channel	turkey	RANDOM
purify	sublimate	SYN
arithmetic	right	RANDOM
blitz	attack	HYPER
barbarian	uncivilized	SYN
adherent	disciple	SYN
beautiful	perfect	RANDOM
bright	apartment	RANDOM
painful	painless	ANT
irritate	nettle	SYN
crawl	stroke	HYPER
bipolar	unipolar	ANT
imperceptible	perceptible	ANT
ice	relax	RANDOM
conveyor	factory	PART_OF
thickly	thinly	ANT
mouth	take	RANDOM
anger	keyboard	RANDOM
choke	dampen	HYPER
bathtub	abode	PART_OF
foreleg	quadruped	PART_OF
pediatrician	medico	HYPER
chocolate	hammer	RANDOM
clothed	unclothed	ANT
marquee	canopy	HYPER
benefit	temple	RANDOM
preparation	resolution	ANT
efflux	influx	ANT
cadence	meter	SYN
fickleness	infidelity	HYPER
member	umbrella	RANDOM
refer	associate	HYPER
assemble	pale	RANDOM
chain	pick	RANDOM
litre	dal	PART_OF
warping	impairment	HYPER
boy	lead	RANDOM
illusion	trick	SYN
parquet	theater	PART_OF
honour	regard	HYPER
dystopia	utopia	ANT
hostess	patron	HYPER
penstock	regulator	HYPER
downmarket	upmarket	ANT
dying	lifetime	PART_OF
umbilical	embryo	PART_OF
butter	quality	RANDOM
paramount	preponderant	SYN
mezzo	mezzo-soprano	SYN
downcast	grim	SYN
sprain	trauma	HYPER
black	white	ANT
revaluation	classification	HYPER
ink	shore	RANDOM
mercer	dealer	HYPER
antiphonal	responsive	SYN
lid	whole	RANDOM
period	aeon	PART_OF
lower	law	RANDOM
re-equip	furnish	HYPER
articled	indentured	SYN
product	outlet	PART_OF
make	short	RANDOM
demolition	destruction	SYN
training	activity	HYPER
cult	fad	SYN
degraded	riotous	SYN
flashy	loud	SYN
back	tall	RANDOM
cheering	shouting	SYN
mid-eighties	eld	PART_OF
pro-choice	pro-life	ANT
ireland	write	RANDOM
porterhouse	beefsteak	HYPER
commode	lav	PART_OF
scriptorium	monastery	PART_OF
irrevocable	revocable	ANT
confinement	pregnancy	PART_OF
civil	uncivil	ANT
burlesque	lampoon	SYN
spinach	spinach	PART_OF
acidic	alkaline	ANT
mind	corn	RANDOM
acid	compound	HYPER
specialize	vary	HYPER
inspiration	ventilation	PART_OF
herder	herdsman	SYN
officer	mariner	HYPER
ascend	understand	RANDOM
blotch	streak	SYN
arch	aqueduct	PART_OF
matter	trunk	RANDOM
arch	arcade	PART_OF
amicable	hostile	ANT
tidy	untidy	ANT
sexism	favoritism	HYPER
daft	wacky	SYN
mil	cl	PART_OF
antiseptic	septic	ANT
planned	unplanned	ANT
noticed	unnoticed	ANT
blockhead	loggerhead	SYN
groin	seawall	SYN
seaworthy	unseaworthy	ANT
normal	paranormal	ANT
downtime	uptime	ANT
foul	revolting	SYN
immeasurable	inestimable	SYN
merry	spanking	SYN
swearing	substance	HYPER
insensitivity	sensitivity	ANT
identifiable	unidentifiable	ANT
applesauce	victuals	HYPER
keel	hull	PART_OF
delicacy	discernment	HYPER
taper	candle	PART_OF
dope	info	HYPER
dextral	sinistral	ANT
compliant	defiant	ANT
jump	nature	RANDOM
recreate	energise	HYPER
span	infrastructure	PART_OF
frail	robust	ANT
manageable	unmanageable	ANT
black	white	ANT
emptiness	fullness	ANT
bedchamber	domicile	PART_OF
evoke	extract	SYN
ragamuffin	tyke	HYPER
index	squash	RANDOM
gauge	guess	SYN
map	crop	RANDOM
antenatal	prenatal	SYN
desalination	desalinization	SYN
shiner	bruise	HYPER
seedless	seedy	ANT
compatibility	incompatibility	ANT
footfall	footstep	SYN
paging	utterance	HYPER
trachea	neck	PART_OF
iron	hostility	RANDOM
beggar	mendicant	SYN
surf	go	HYPER
adit	colliery	PART_OF
singles	tennis	HYPER
clog	foul	SYN
bill	trousers	RANDOM
lace	train	RANDOM
abuse	vilification	SYN
bellybutton	belly	PART_OF
intake	breathing	PART_OF
paintball	capsule	HYPER
collectivist	state-controlled	SYN
stump	mystify	HYPER
agreement	statue	RANDOM
commencement	start	SYN
moved	unmoved	ANT
enforced	unenforced	ANT
turmeric	turmeric	PART_OF
croup	quadruped	PART_OF
parlor	habitation	PART_OF
calm	useless	RANDOM
corrected	uncorrected	ANT
listed	unlisted	ANT
questioner	speaker	HYPER
male	joint	RANDOM
instrumental	vocal	ANT
noticeable	unnoticeable	ANT
instep	pes	PART_OF
behind	buns	SYN
goalie	goalkeeper	SYN
loose	idle	RANDOM
conspicuously	inconspicuously	ANT
pint	quart	PART_OF
homeowner	householder	SYN
convincingly	unconvincingly	ANT
fellow	twain	PART_OF
atmosphere	marriage	RANDOM
efflux	influx	ANT
venturi	carburetor	PART_OF
discouragement	encouragement	ANT
image	conclusion	RANDOM
hardship	rigour	SYN
processor	concern	HYPER
wired	wireless	ANT
evermore	forever	SYN
repulse	rejection	HYPER
naivete	sophistication	ANT
salmon	salmon	PART_OF
exudate	excrete	HYPER
hardball	softball	ANT
slimy	unworthy	SYN
language	subject	RANDOM
nonproliferation	proliferation	ANT
aid	cube	RANDOM
batten	lumber	HYPER
concave	convex	ANT
music	old	RANDOM
high	auto	PART_OF
hardware	software	ANT
air-to-surface	surface-to-air	ANT
masonry	building	PART_OF
house	rubber	RANDOM
magnolia	magnolia	PART_OF
eukaryotic	prokaryotic	ANT
cruise	journey	HYPER
week	workweek	SYN
trimmed	untrimmed	ANT
analogue	digital	ANT
pain	rain	RANDOM
elegant	graceful	SYN
ice	log	RANDOM
jacket	landscape	RANDOM
foretell	portend	SYN
profane	sacred	ANT
impetus	impulse	SYN
matriculate	register	HYPER
lobby	attach	RANDOM
anal	oral	ANT
deuce	dickens	SYN
basement	dull	RANDOM
peace	crystal	RANDOM
shadowy	vague	SYN
dysphoria	euphoria	ANT
accident	hero	RANDOM
queasy	unquiet	SYN
chorus	vocal	PART_OF
cheat	bounce	RANDOM
loaded	unloaded	ANT
beauty	hat	RANDOM
micron	centimetre	PART_OF
grave	sculpt	SYN
flue	passage	HYPER
potpourri	variety	SYN
part	passageway	RANDOM
leak	travel	RANDOM
dm	metre	PART_OF
black	kitchen	RANDOM
innate	natural	SYN
incoming	outgoing	ANT
retrieve	fetch	HYPER
skullcap	braincase	PART_OF
crib	cribbage	PART_OF
sonic	supersonic	ANT
stagger	put	HYPER
ceiling	rest	RANDOM
limb	portion	HYPER
disgraceful	shameful	SYN
candy	toe	RANDOM
naturally	unnaturally	ANT
amphibious	aquatic	ANT
enunciate	vocalize	SYN
phosphate	beverage	HYPER
conventional	nuclear	ANT
beast	aggressor	HYPER
factor	chromosome	PART_OF
serviceable	unserviceable	ANT
centimetre	dm	PART_OF
manufacture	wolf	RANDOM
leave	refuse	RANDOM
80	eighty	SYN
newsroom	office	HYPER
hierarchy	administration	PART_OF
dignified	undignified	ANT
songbird	songster	SYN
taoiseach	premier	HYPER
peak	arrow	PART_OF
reparation	redemption	HYPER
mess	plenty	SYN
employed	unemployed	ANT
hypothalamus	forebrain	PART_OF
belief	have	RANDOM
middle	sock	RANDOM
stud	building	PART_OF
fontanelle	shaver	PART_OF
idling	deed	HYPER
bit	skyscraper	RANDOM
girdle	sash	SYN
arrest	collar	SYN
dicky	shirt	PART_OF
slug	cartridge	PART_OF
glued	pasted	SYN
advance	poem	RANDOM
drover	herdsman	SYN
frog	ornamentation	HYPER
account	friendly	RANDOM
medicine	finish	RANDOM
mcg	mg	PART_OF
book	rare	RANDOM
morning	joy	RANDOM
misery	gay	RANDOM
bodyguard	retinue	PART_OF
measly	paltry	SYN
gumming	chewing	HYPER
amaze	perplex	SYN
reconstructed	unreconstructed	ANT
convenience	inconvenience	ANT
strap	brace	PART_OF
hit	fix	RANDOM
chickpea	chickpea	PART_OF
gravestone	tomb	PART_OF
mix	child	RANDOM
prodigal	profligate	SYN
archaeological	archeological	SYN
hollowness	solidity	ANT
accede	defer	SYN
changeable	unchangeable	ANT
hanger	someone	HYPER
goodly	respectable	SYN
blinder	blinker	SYN
channel	structure	HYPER
criminalise	criminalize	SYN
hindquarters	keister	SYN
activation	deactivation	ANT
coarsely	finely	ANT
inscribe	promise	HYPER
asymmetry	symmetry	ANT
caribou	reindeer	SYN
dumps	mopes	SYN
adjective	adjective	PART_OF
subscript	superscript	ANT
infield	outfield	ANT
bricklayer	journeyman	HYPER
downstairs	upstairs	ANT
necessarily	unnecessarily	ANT
passer	cause	HYPER
delivery	childbearing	PART_OF
paying	salaried	SYN
provide	transfer	HYPER
barefoot	shoeless	SYN
windscreen	powerboat	PART_OF
debar	obviate	SYN
covert	overt	ANT
rockfish	rockfish	PART_OF
integrate	figure	HYPER
altruistic	egoistic	ANT
align	jibe	HYPER
cartridge	phonograph	PART_OF
precept	ethic	PART_OF
structured	unstructured	ANT
bicameral	unicameral	ANT
bend	park	RANDOM
pocketbook	purse	SYN
fewest	most	ANT
cappuccino	java	HYPER
rearward	rearwards	SYN
greenbelt	greenway	SYN
whisk	mixer	HYPER
curing	plastination	PART_OF
monitor	album	RANDOM
inoperative	operative	ANT
inward	outward	ANT
foaming	foamy	SYN
accommodate	fit	SYN
medical	surgical	ANT
circular	round	SYN
snorkel	sub	PART_OF
keyed	keyless	ANT
synapsid	reptilian	HYPER
gelatin	nutrition	HYPER
tranquility	disposition	HYPER
snuff	candlewick	PART_OF
perk	better	HYPER
soya	soya	PART_OF
range	scope	SYN
insane	sane	ANT
heartache	heartbreak	SYN
ascent	descent	ANT
sauce	repast	PART_OF
poke	perforate	HYPER
baseball	molecule	RANDOM
encroach	infringe	SYN
gumming	mumbling	SYN
palatable	toothsome	SYN
cast-iron	iron	SYN
tomatillo	tomatillo	PART_OF
nonpayment	commercialism	HYPER
sura	shank	PART_OF
nada	null	SYN
brat	rascal	HYPER
penetration	intercourse	HYPER
box	slow	RANDOM
stub	thing	HYPER
mask	artefact	HYPER
tidbit	treat	HYPER
clip	health	RANDOM
honk	puke	SYN
carry	wind	RANDOM
erg	unit	HYPER
hit	state	RANDOM
fright	scare	SYN
altruism	egoism	ANT
pepper	seasoning	HYPER
compatible	incompatible	ANT
instability	stability	ANT
coda	opus	PART_OF
vitamin	nutrient	HYPER
riding	athletics	HYPER
crack	gap	SYN
bolt	you	RANDOM
murder	continent	RANDOM
carat	gramme	PART_OF
observer	being	HYPER
rail	denounce	HYPER
expose	peril	SYN
counsel	discuss	HYPER
answer	sheep	RANDOM
insensitivity	sensitivity	ANT
juvenile	somebody	HYPER
poke	thrusting	SYN
channel	equal	RANDOM
chair	member	RANDOM
hatch	scuttle	PART_OF
dock	seafront	PART_OF
iron	unhappiness	RANDOM
differentiated	undifferentiated	ANT
micron	mm	PART_OF
aggregate	totality	SYN
admire	tight	RANDOM
ringlet	coiffure	PART_OF
brewpub	works	HYPER
posterior	torso	PART_OF
conserve	conserves	SYN
articulate	inarticulate	ANT
milk	town	RANDOM
balance	shoe	RANDOM
straining	twisting	SYN
pass	health	RANDOM
daemon	fiend	SYN
sure	unsure	ANT
shelf	bookcase	PART_OF
memory	platform	PART_OF
disorder	upset	HYPER
feminine	neuter	ANT
importer	capitalist	HYPER
harmful	harmless	ANT
cannon	carom	SYN
26	twenty-six	SYN
thesaurus	reference	HYPER
derision	doings	HYPER
response	mode	HYPER
gramme	hg	PART_OF
legislating	governance	HYPER
keenness	intelligence	HYPER
strictness	temperament	HYPER
location	studio	ANT
mate	log	RANDOM
narrowness	breadth	HYPER
modesty	reserve	SYN
manufacture	unsettle	RANDOM
collateral	indirect	SYN
disequilibrium	equilibrium	ANT
commonality	individuality	ANT
boil	minute	RANDOM
synchronize	arrange	HYPER
ancestry	blood	SYN
trench	entrenchment	PART_OF
formula	message	HYPER
mm	cm	PART_OF
bow	plot	RANDOM
bin	even	RANDOM
reversion	turnabout	SYN
heady	reckless	SYN
passionate	passionless	ANT
painting	building	PART_OF
heterosexual	violent	RANDOM
feathering	rowing	PART_OF
costa	vertebrate	PART_OF
house	radio	RANDOM
leave	fruit	RANDOM
barmy	crackers	SYN
saturation	vividness	SYN
publication	publishing	SYN
imprudent	prudent	ANT
abnormality	normality	ANT
pre-empt	bidding	HYPER
consciously	unconsciously	ANT
brave	cannabis	RANDOM
trailer	rig	PART_OF
foreclose	forestall	SYN
consignment	loading	SYN
indecipherable	unclear	SYN
chop	mild	RANDOM
bathtub	planet	RANDOM
aileron	aeroplane	PART_OF
birth	paint	RANDOM
stumble	go	HYPER
sequence	flick	PART_OF
organ	blade	RANDOM
circle	jump	RANDOM
fountainhead	source	HYPER
misery	experiment	RANDOM
riskiness	condition	HYPER
rerun	broadcast	HYPER
patter	spiel	SYN
nothing	happy	RANDOM
urethra	vulva	PART_OF
instalment	series	PART_OF
bullying	conduct	HYPER
tip-off	basketball	PART_OF
downstage	theater	PART_OF
hyacinth	jacinth	SYN
decreased	increased	ANT
jowl	homo	PART_OF
dl	dal	PART_OF
radius	cartwheel	PART_OF
terrify	scare	HYPER
juggernaut	steamroller	SYN
ice	stop	RANDOM
edging	arras	PART_OF
primary	secondary	ANT
vocalize	enunciate	HYPER
arithmetic	huge	RANDOM
hot	smile	RANDOM
microsecond	sec	PART_OF
snit	irritation	HYPER
minister	residence	RANDOM
comical	funny	SYN
lunch	television	RANDOM
mastoid	braincase	PART_OF
blunt	crude	SYN
bedroom	suffer	RANDOM
cathode	tube	PART_OF
relapsing	reversion	SYN
export	import	ANT
branch	positive	RANDOM
cent	leone	PART_OF
runway	airstrip	PART_OF
blare	clamor	SYN
pertain	refer	SYN
china	girlfriend	RANDOM
manufacture	simple	RANDOM
perfect	sit	RANDOM
gyrus	cerebrum	PART_OF
bed	miss	RANDOM
forfeit	forfeiture	SYN
marauder	offender	HYPER
midfield	arena	PART_OF
mesmerize	influence	HYPER
elk	wapiti	SYN
jade	slut	SYN
bottom	torso	PART_OF
bract	husk	HYPER
matter	stripe	RANDOM
flotilla	aggregation	HYPER
lazy	story	RANDOM
hit	stumble	SYN
strap	shimmy	PART_OF
threaten	inform	HYPER
historicism	concept	HYPER
rabble	rout	SYN
best	worst	ANT
convenience	inconvenience	ANT
healthful	unhealthful	ANT
enforceable	unenforceable	ANT
mesh	in	PART_OF
colorful	colorless	ANT
sustenance	upkeep	SYN
edible	inedible	ANT
folly	wisdom	ANT
america	recess	RANDOM
hydrophilic	hydrophobic	ANT
wage	payroll	PART_OF
mainspring	clockwork	PART_OF
avoidance	dodging	SYN
mitigated	unmitigated	ANT
imperious	swaggering	SYN
insincerity	sincerity	ANT
appointive	elective	ANT
life	relax	RANDOM
registered	unregistered	ANT
thalamus	forebrain	PART_OF
dal	hl	PART_OF
dub	ennoble	HYPER
below	beneath	SYN
equipping	mobilization	HYPER
core	reactor	PART_OF
appear	experiment	RANDOM
imperceptibly	perceptibly	ANT
clutch	clutch	PART_OF
establish	cause	HYPER
classroom	schoolroom	SYN
commercial	advertising	HYPER
winged	wingless	ANT
marbles	wits	SYN
addition	subtraction	ANT
badger	vex	HYPER
kitten	teach	RANDOM
actor	mild	RANDOM
colour	gloss	SYN
aurochs	ox	HYPER
athlete	master	RANDOM
language	beach	RANDOM
bellicosity	aggressiveness	HYPER
intolerable	tolerable	ANT
scruple	hesitate	HYPER
oz.	pound	PART_OF
bar	you	RANDOM
lacquer	beautify	HYPER
accident	restrict	RANDOM
beautiful	courage	RANDOM
orient	displace	HYPER
episcopacy	episcopate	SYN
inferiority	superiority	ANT
asymmetry	symmetry	ANT
monolingual	multilingual	ANT
circle	ideology	RANDOM
specialism	specialization	SYN
vane	propeller	PART_OF
uptick	dealing	HYPER
shameful	shocking	SYN
chicory	chicory	PART_OF
roar	wail	SYN
absence	presence	ANT
batty	daft	SYN
nan	forebear	HYPER
invariable	variable	ANT
throne	can	PART_OF
disruptive	troubled	SYN
beach	stock	RANDOM
fiddle	repair	HYPER
shank	skillet	PART_OF
gush	outburst	SYN
loudly	softly	ANT
choke	circuit	PART_OF
wrecker	workman	HYPER
carburetor	carburettor	SYN
absorption	extinction	PART_OF
hernia	injury	HYPER
raid	contend	HYPER
cheer	measure	HYPER
dour	unyielding	SYN
asymmetric	asymmetrical	SYN
feasible	viable	SYN
century	millennium	PART_OF
blowhole	airway	PART_OF
bad	mobile	RANDOM
cloud	powerful	RANDOM
calf	shoe	RANDOM
hope	mug	RANDOM
calling	vocation	SYN
walk-in	wrongdoer	HYPER
determinate	indeterminate	ANT
tram	instrumentation	HYPER
inventory	product	HYPER
manoeuvre	tactic	SYN
segregation	meiosis	PART_OF
lesson	pedagogy	PART_OF
mankind	pen	RANDOM
helpful	unhelpful	ANT
glide	sailing	SYN
lunch	justice	RANDOM
base	writer	RANDOM
maxi	midi	ANT
conflagration	occurrence	HYPER
agitation	calmness	ANT
pintle	hinge	PART_OF
ignorance	fact	RANDOM
resistance	circuit	PART_OF
bias	act	RANDOM
hill	ride	RANDOM
doorman	porter	SYN
image	smoke	RANDOM
factor	nucleus	PART_OF
nub	sum	SYN
stiffen	curb	HYPER
prepared	unprepared	ANT
judging	judgment	SYN
sparkling	still	ANT
bedchamber	abode	PART_OF
difficulty	ease	ANT
in-fighting	struggle	HYPER
goldsmith	maker	HYPER
like	outside	RANDOM
latex	emission	HYPER
black	damage	RANDOM
moonbeam	moonshine	PART_OF
leaf	brush	RANDOM
branch	split	RANDOM
cylinder	aqualung	PART_OF
numb	alter	HYPER
lean	rich	ANT
7	seven	SYN
poll	horse	PART_OF
144	gross	SYN
streak	happening	HYPER
insubordination	subordination	ANT
inset	garment	PART_OF
conditional	unconditional	ANT
light	idle	RANDOM
nanny	nursemaid	SYN
active	pitch	RANDOM
advisable	inadvisable	ANT
kayak	canoe	HYPER
treated	untreated	ANT
pickup	phonograph	PART_OF
accomplice	confederate	SYN
waggle	wiggle	HYPER
product	commodity	HYPER
loose	travel	RANDOM
budgie	lovebird	SYN
halter	headgear	HYPER
hoop	cask	PART_OF
perinatal	prenatal	ANT
deflation	inflation	ANT
blueprint	draught	SYN
dryly	laconically	SYN
jimmy	lever	SYN
escutcheon	poop	PART_OF
oxygen	lie	RANDOM
continental	intercontinental	ANT
storyteller	liar	HYPER
horse	force	HYPER
exhaust	auto	PART_OF
jackal	canine	HYPER
rails	tramline	PART_OF
sway	modify	HYPER
inhale	inspire	SYN
loud	democracy	RANDOM
attached	detached	ANT
demotion	promotion	ANT
crawlspace	building	PART_OF
prize	trophy	SYN
cancel	scratch	SYN
agnostic	gnostic	ANT
contrast	differ	HYPER
entirely	exclusively	SYN
sector	battlefield	PART_OF
bin	angel	RANDOM
cipher	zip	SYN
transit	infrastructure	PART_OF
howl	howling	SYN
runway	tramway	PART_OF
note	mankind	RANDOM
pirate	felon	HYPER
guava	guava	PART_OF
idle	brush	RANDOM
multiple	single	ANT
detected	undetected	ANT
motored	motorised	SYN
familiarity	unfamiliarity	ANT
imagination	door	RANDOM
nothing	lead	RANDOM
distaff	sphere	HYPER
stun	curb	HYPER
tracking	trailing	SYN
mutually	reciprocally	SYN
boss	politico	HYPER
nation	sidewalk	RANDOM
shank	spigot	PART_OF
tailfin	auto	PART_OF
exemplary	model	SYN
thunder	utter	HYPER
bolt	mold	RANDOM
imprecision	precision	ANT
elude	evade	SYN
park	rubber	RANDOM
butter	flight	RANDOM
eggnog	punch	HYPER
accessible	inaccessible	ANT
bowl	statement	RANDOM
immutable	mutable	ANT
epithet	characterisation	HYPER
dumping	mercantilism	HYPER
hemisphere	cerebrum	PART_OF
remission	rescue	HYPER
figure	soma	SYN
lid	lobby	RANDOM
misery	gift	RANDOM
shroud	tack	SYN
poverty	wealth	ANT
lose	experiment	RANDOM
stair	staircase	PART_OF
backed	backless	ANT
parquet	theatre	PART_OF
pace	perch	PART_OF
multinomial	polynomial	SYN
move	view	RANDOM
principled	unprincipled	ANT
chancy	iffy	SYN
contentment	discontentment	ANT
loon	loafer	HYPER
beseech	request	HYPER
allow	estimate	HYPER
forte	piano	ANT
cockamamie	goofy	SYN
curse	whammy	SYN
zip	fixing	HYPER
contractor	somebody	HYPER
downtick	uptick	ANT
cuff	sleeve	PART_OF
remit	wait	HYPER
guttural	consonant	HYPER
campground	site	HYPER
hao	dong	PART_OF
plebeian	unwashed	SYN
hip	pelvis	PART_OF
land	push	RANDOM
dough	moolah	SYN
employment	unemployment	ANT
osmosis	dialysis	PART_OF
harper	musician	HYPER
pock	variola	PART_OF
summoning	exorcism	PART_OF
agonist	antagonist	ANT
pale	chain	RANDOM
levy	militarization	HYPER
rib	comment	HYPER
barbed	prickly	SYN
recoverable	unrecoverable	ANT
impolitic	politic	ANT
artificially	unnaturally	SYN
anther	bloom	PART_OF
cabana	shelter	HYPER
twosome	yoke	SYN
damselfish	demoiselle	SYN
bleary	fuzzy	SYN
clove	bud	HYPER
graphics	publication	PART_OF
frostbite	injury	HYPER
confusion	compounding	HYPER
campaign	crusade	SYN
nominative	oblique	ANT
cheerfulness	temperament	PART_OF
leaf	divide	RANDOM
vent	airway	PART_OF
amass	conglomerate	SYN
turbofan	turbojet	PART_OF
medley	composition	HYPER
rat	coif	PART_OF
nevus	mar	HYPER
lawful	unlawful	ANT
hauler	constructor	HYPER
insecurity	security	ANT
shredder	instrumentality	HYPER
absurd	nonsensical	SYN
nibble	byte	PART_OF
cannon	biped	PART_OF
busy	apartment	RANDOM
designate	appoint	HYPER
people	abstraction	HYPER
detainee	prisoner	HYPER
heap	stack	SYN
dissimilarity	similarity	ANT
bottleneck	stymie	HYPER
pantheism	theism	HYPER
diabetic	sufferer	HYPER
landing	staircase	PART_OF
adventure	hazard	SYN
ignition	lighting	SYN
savage	primitive	HYPER
blow	letter	RANDOM
meat	succeed	RANDOM
breast	leg	RANDOM
invasive	noninvasive	ANT
bet	pool	PART_OF
caustic	sulfurous	SYN
elbow	arm	PART_OF
stretcher	edifice	PART_OF
marten	carnivore	HYPER
teahouse	building	HYPER
artillery	force	HYPER
evening	nighttime	PART_OF
gestural	nonverbal	SYN
bar	saloon	PART_OF
beauty	unkind	RANDOM
skeletal	wasted	SYN
scheduled	unscheduled	ANT
excusable	forgivable	SYN
ecumenism	creed	HYPER
arithmetic	saucepan	RANDOM
familiarity	unfamiliarity	ANT
trait	somebody	PART_OF
chomping	chewing	HYPER
cloud	galaxy	RANDOM
sitter	model	HYPER
pendant	necklace	PART_OF
distributary	tributary	ANT
shift	workday	PART_OF
dreaded	horrific	SYN
abundance	scarcity	ANT
cassava	manioc	PART_OF
halberd	arm	HYPER
palm	arm	PART_OF
deterrence	disincentive	SYN
old	food	RANDOM
clean	clothe	RANDOM
studied	unstudied	ANT
blue	spicy	SYN
affection	smooth	RANDOM
conjunctive	disjunctive	ANT
skirt	garment	PART_OF
telomere	chromosome	PART_OF
idolised	idolized	SYN
curate	pastor	SYN
hyperglycemia	hypoglycemia	ANT
episcopacy	grouping	HYPER
lung	instruction	RANDOM
civil	sidereal	ANT
scent	ameliorate	HYPER
44	forty-four	SYN
leverage	leveraging	SYN
privately	publicly	ANT
bow	doorway	RANDOM
cortex	medulla	ANT
retail	wholesale	ANT
rag	week	HYPER
lepton	drachma	PART_OF
citation	extract	HYPER
idle	neutron	RANDOM
softness	tolerance	HYPER
disinclined	inclined	ANT
penstock	sluice	PART_OF
sensation	wizard	SYN
minster	monastery	PART_OF
employment	unemployment	ANT
innards	viscera	SYN
raphe	scrotum	PART_OF
micrometer	millimetre	PART_OF
formalism	imitation	ANT
loaded	plastered	SYN
change	motorcycle	RANDOM
accurate	inaccurate	ANT
move	lightweight	RANDOM
dove	hawk	ANT
lock	far	RANDOM
playback	recorder	PART_OF
squeamishness	cleanliness	HYPER
muller	implement	HYPER
producer	shaper	HYPER
clock	vegetable	RANDOM
tuneful	tuneless	ANT
documented	undocumented	ANT
meat	hobby	RANDOM
cinnabar	vermillion	SYN
prefer	designate	HYPER
lung	day	RANDOM
minaret	mosque	PART_OF
sunburn	suntan	SYN
miss	table	RANDOM
convulsive	spastic	SYN
alignment	organisation	HYPER
enough	amount	HYPER
personify	embody	HYPER
tub	dwelling	PART_OF
shaft	spear	SYN
hiatus	interruption	HYPER
lens	word	RANDOM
coir	fiber	HYPER
coolness	calmness	HYPER
belt	victory	RANDOM
painted	unpainted	ANT
foreskin	vulva	PART_OF
slog	slug	SYN
christian	unhappy	RANDOM
mark	boredom	RANDOM
necessitate	require	SYN
taxidermy	artistry	HYPER
tonsil	throat	PART_OF
whorl	coif	PART_OF
blight	plague	SYN
hurt	mild	RANDOM
windowpane	building	PART_OF
cell	erect	RANDOM
con	pro	ANT
poverty	wealth	ANT
annual	perennial	ANT
tip	arrowhead	PART_OF
micrometer	millimeter	PART_OF
fettuccine	pasta	HYPER
batty	nutty	SYN
imperturbable	unflappable	SYN
insubordination	subordination	ANT
praxis	deed	HYPER
sucker	sucker	PART_OF
hillock	knoll	SYN
classicist	romanticist	ANT
naturalistic	realistic	SYN
loud	sky	RANDOM
scoreboard	signboard	HYPER
lose	union	RANDOM
proactive	retroactive	ANT
almond	almond	PART_OF
shoji	covert	HYPER
forehead	braincase	PART_OF
skid	chute	PART_OF
dynamism	vigor	SYN
like	fan	RANDOM
bone	hear	RANDOM
lose	fashion	RANDOM
bothersome	galling	SYN
off-line	on-line	ANT
independence	team	RANDOM
flagellum	sperm	PART_OF
old	sickness	RANDOM
packer	footer	HYPER
plastered	slicked	SYN
illness	couple	RANDOM
bow	care	RANDOM
airplane	complex	RANDOM
class	drug	RANDOM
overproduction	overrun	SYN
vamp	upper	PART_OF
thoughtfulness	personality	PART_OF
hypocrite	cheater	HYPER
barb	hook	PART_OF
coney	das	SYN
appearance	disappearance	ANT
irresolute	resolute	ANT
armature	fridge	PART_OF
characteristically	uncharacteristically	ANT
pal	sidekick	SYN
light	individual	RANDOM
line	mature	RANDOM
shoulder	garment	PART_OF
tatty	trashy	SYN
heirloom	heritage	PART_OF
brand	designate	HYPER
generality	particularity	ANT
extraterritorial	territorial	ANT
spattering	splatter	SYN
qualitative	quantitative	ANT
shank	quadruped	PART_OF
muster	say	HYPER
sincerity	naturalness	HYPER
elastic	artefact	HYPER
hurt	center	RANDOM
ng	milligram	PART_OF
throne	abode	PART_OF
cutting	cards	PART_OF
casing	edifice	PART_OF
palisade	surround	SYN
agitate	rouse	SYN
beauty	ideal	HYPER
hot	unusual	RANDOM
fallibility	infallibility	ANT
range	pose	HYPER
skid	slide	PART_OF
civilian	serviceman	ANT
porterhouse	boeuf	PART_OF
studentship	position	HYPER
describe	elaborate	HYPER
kurta	garment	HYPER
cartoonist	draftsman	HYPER