orbe	girar	SYN
mago	mago	SYN
valiente	razón	RANDOM
comprar	untado	RANDOM
sonda	investigación	HYPER
electrodo	batería	PART_OF
ordinario	cascada	RANDOM
clarín	exclamar	HYPER
negatividad	positividad	ANT
en medio del barco	en medio del navío	SYN
saboreando	saboreando	SYN
nuez	nuez	PART_OF
parcialidad	equipo	RANDOM
expansivo	hablador	SYN
narración	mensaje	HYPER
pasto	pastar	SYN
caldera	edificio	PART_OF
cambiador	fonógrafo	PART_OF
no combatiente	militar	HYPER
arándano	arándano	PART_OF
teclado	infeliz	RANDOM
optimismo	desesperación	ANT
Bema	Iglesia	PART_OF
cumpleaños	cielo	RANDOM
conductor	aislante	ANT
encasillar	estereotipo	SYN
rezagado	perezoso	HYPER
proceso	mando	HYPER
objeto	silencio	RANDOM
cerebro	radio	RANDOM
pectoral	vertebrado	PART_OF
bar	trama	RANDOM
empleable	unemployable	ANT
magníficamente	magníficamente	SYN
enfático	fuerte	SYN
menguante	depilación	ANT
centavo	florín	PART_OF
Puerro	Puerro	PART_OF
ártico	gumshoe	SYN
ópalo	joya	HYPER
hundimiento	colapso	HYPER
ruido	salir	RANDOM
arte de vender	adquisición	HYPER
pasillo	bueno	RANDOM
cosas	pertenencias	HYPER
arena	cuenco	SYN
Rico	robusto	SYN
avión	planta	RANDOM
censurado	sin censura	ANT
generalización	aprendizaje	HYPER
Asia	dedo del pie	RANDOM
moolah	wampum	SYN
panza	rumiante	PART_OF
robustez	validez	SYN
proteger	molusco	PART_OF
delantal	tránsito	PART_OF
agregador	siendo	HYPER
recordar	intentar	HYPER
cita	determinación	HYPER
ejecutante	alguien	HYPER
existente	inexistente	ANT
demostrativo	ilustrativo	SYN
ef	par	HYPER
pecarí	ungulado	HYPER
Wilding	alboroto	HYPER
puntualidad	tardanza	ANT
zumbido	ocurrencia	HYPER
nariz	metal	RANDOM
inversión	giro total	SYN
eficaz	ineficaz	ANT
tierras altas	tierras bajas	ANT
kilobyte	gigabyte	PART_OF
Fresco	Preservado	ANT
bruto	fauna	SYN
calificado	no cualificado	ANT
definido	esbozado	SYN
augur	presagio	SYN
marca	cuidado	RANDOM
enfermedad	entrenador	RANDOM
subtitular	película	PART_OF
garra	atacar	HYPER
activador	inhibidor	ANT
noble	aristócrata	ANT
insufrible	inaceptable	SYN
impracticabilidad	sentido práctico	ANT
sangre fría	de sangre caliente	ANT
sin rivalidad	sin rivalidad	SYN
silla	herramienta	RANDOM
borradura	dolores del parto	PART_OF
atleta	difícil	RANDOM
globo del ojo	óculo	PART_OF
hermosa	carta	RANDOM
gigantescos	descomunal	SYN
juntarse	unir	SYN
accionar	rápido	SYN
miembro	pasillo	RANDOM
mandioca	mandioca	HYPER
imperioso	orgulloso	SYN
pesadez	ligereza	ANT
oropel	modificar	HYPER
campaña	prevención	HYPER
fuga	marcha atrás	RANDOM
previsibilidad	imprevisibilidad	ANT
centro de la ciudad	zona residencial	ANT
implausibilidad	plausibilidad	ANT
becerro	gritar	RANDOM
importante	sin importancia	ANT
pollo	importar	RANDOM
pica	pulgada	PART_OF
calma	Cállate	HYPER
culpa	inocencia	ANT
coordinado	coordinado	SYN
hiperglucemia	hipoglucemia	ANT
pagado	pago	SYN
mente	sombra	RANDOM
acuerdo	armonizar	SYN
quebrada	Valle	HYPER
puntal	pavonearse	SYN
lucha	agitar	HYPER
intestino	estómago	PART_OF
veraniego	invernal	ANT
disciplina	indisciplina	ANT
inmodestamente	modestamente	ANT
Confusión	desorden	SYN
mamparo	dividir	HYPER
puñetazo	perforar	HYPER
acidez	alcalinidad	ANT
agobiados	sin cargas	ANT
China	veneno	RANDOM
cl	l	PART_OF
fuente de dinero	programa	HYPER
cultivador	Jack	HYPER
baloncesto	vacío	RANDOM
media	juego	RANDOM
escálamo	bote	PART_OF
frivolidad	gravedad	ANT
antónimo	sinónimo	ANT
clinch	restricción	HYPER
reventa	comercialización	HYPER
cambio	cambio	HYPER
Carnicero	sacrificio	SYN
mandíbula	caput	PART_OF
chaqueta	corto	RANDOM
desplazamiento	traducción	HYPER
sopladura	soplador	PART_OF
cidra	cidra	PART_OF
preocupado	sin problemas	ANT
maldición	tipo de	SYN
montaña	hablar	RANDOM
exterminar	desarraigar	SYN
frente	campo de batalla	PART_OF
monismo	pluralismo	ANT
crepúsculo	víspera	PART_OF
aprobación	desaprobación	ANT
Convincente	poco convincente	ANT
virreinato	jurisdicción	HYPER
plantilla	impresión	HYPER
barco	ascensor	RANDOM
estrechamiento	ensanchamiento	ANT
pacifismo	doctrina	HYPER
matriz	OS	PART_OF
felizmente	alegremente	SYN
paga	piel	RANDOM
pecho	habitar	RANDOM
feminidad	masculinidad	ANT
cocido	crudo	ANT
desesperación	esperanza	ANT
antecedente	subsecuente	ANT
genérico	varietal	ANT
cargador	obrero	HYPER
rebaba	pericarpio	HYPER
carne de vaca	sol	RANDOM
efervescencia	potable	HYPER
kilogramo	métrico	HYPER
angstrom	micrón	PART_OF
radomo	avión	PART_OF
conservador	liberal	ANT
ánodo	circuito	PART_OF
clase	grande	RANDOM
promesa	parte	HYPER
años	toda la vida	PART_OF
molestar	molestia	HYPER
pecado	transgredir	HYPER
atestar	Listo	HYPER
suelto	cabeza	RANDOM
descenso	compartimentación	HYPER
máximo	mínimo	ANT
yo	juicio	RANDOM
irreversibilidad	reversibilidad	ANT
tratamiento	escritura	HYPER
promesa	premio	HYPER
masticación	alimentación	PART_OF
llamada	apoyo	RANDOM
paso	para caminar	PART_OF
encimera	mesa	HYPER
micado	emperador	HYPER
tanteador	juez	HYPER
insensible	inafectado	SYN
nucleón	núcleo	PART_OF
discernible	evidente	SYN
poco	democracia	RANDOM
hipertensión	hipotensión	ANT
comerciante	comerciante	SYN
recomendación	testimonial	SYN
pestilencia	determinador	HYPER
parachoque	automóvil	PART_OF
irresponsabilidad	responsabilidad	ANT
directo	retrógrado	ANT
desensibilizar	modificar	HYPER
paraquat	herbicida	HYPER
nuevo	estrella	RANDOM
ab	abdomen	PART_OF
burlón	burlón	SYN
bueno	autorizar	HYPER
de modo realista	irrealmente	ANT
nitidez	blandura	ANT
albumen	albúmina	SYN
casa	dinero	RANDOM
inducido	espontáneo	ANT
saltar	mortal	RANDOM
lb	quintal	PART_OF
desnudo	cubierto	ANT
financiero	no financiero	ANT
aquí	ahí	ANT
desintegrarse	alterar	HYPER
mansedumbre	sumisión	SYN
ceder	Rendición	SYN
zumbido	cornamusa	PART_OF
poder	domicilio	PART_OF
flor	angiosperma	PART_OF
ganso	cortar	HYPER
descendencia	alto	RANDOM
límite	límites	SYN
insectívoro	omnívoro	ANT
subsónico	supersónico	ANT
constitución	atributo	HYPER
vaso	inguinal	HYPER
canabis	disco	RANDOM
emancipado	libertador	HYPER
hablador	talky	SYN
inmersión	concentrado	HYPER
empíricamente	teóricamente	ANT
cascarrabias	brusco	SYN
bañista	alguien	HYPER
colaboracionista	colaborador	SYN
directamente	en el acto	SYN
bunsen	Etna	SYN
cargando	descarga	ANT
sacrificio	carnicería	PART_OF
vestíbulo	utilizar	RANDOM
insincero	sincero	ANT
torpe	incómodo	SYN
bisagra	automóvil	PART_OF
alcance del oído	alcanzar	HYPER
emitir	dados	PART_OF
importar	caminar	RANDOM
concepción	Idea equivocada	ANT
porta	fuselaje	PART_OF
lucha	tratar	HYPER
oscuridad	prominencia	ANT
dañado	sin daños	ANT
badajo	faringe	PART_OF
avanzar	retirada	ANT
drumlin	masa	HYPER
Mañana	frágil	RANDOM
nivel	mujer	RANDOM
Misisipí	vehículo	RANDOM
deseducado	indocto	SYN
aire-aire	aire-superficie	ANT
costa afuera	onshore	ANT
baloncesto	personal	RANDOM
nudo	sueño	RANDOM
higo	ilustración	HYPER
cap	talador	SYN
pacer	rastrillo	SYN
puñalada	actividad	HYPER
guión	sin guión	ANT
quilla	motos acuáticas	PART_OF
código postal	misiva	PART_OF
favorablemente	desfavorablemente	ANT
democrático	no democrático	ANT
molesto	tedioso	SYN
elaborar	dilucidar	HYPER
murciélago	ventana	RANDOM
bloquear	estrella	RANDOM
nudo	hora	RANDOM
núcleo	imán	PART_OF
veleta	helicóptero	PART_OF
continuamente	inestablemente	ANT
avanzar	calcetín	RANDOM
suelo	contener	HYPER
mapa	objeto	RANDOM
barraca	exaltar	HYPER
mendacidad	veracidad	ANT
establecimiento	autoridades	PART_OF
labor	el embarazo	PART_OF
pierna	entender mal	RANDOM
Oxalis	Alazán	SYN
oblicuidad	el embarazo	PART_OF
pistacho	pistacho	PART_OF
noviazgo	oración	HYPER
menor	venial	SYN
Baldy	alguien	HYPER
falsedad	falsedad	SYN
esclerótico	óptico	PART_OF
bola rápida	entrega	HYPER
cuidado	imagen	RANDOM
cadena	jugar	RANDOM
pene	industria	RANDOM
telaraña	transparente	SYN
exhortar	consejo	HYPER
canon	barranco	HYPER
condensación	condensación	SYN
endulzar	alterar	HYPER
sin luna	de luna	ANT
competentemente	incompetente	ANT
rueda de espigas	cámara	PART_OF
enfermera	niñera	SYN
sección en medio	torso	PART_OF
comienzo	asustar	SYN
civilización	toro	RANDOM
decisión	indecisión	ANT
paliza	flagelación	SYN
sutura	operación	PART_OF
criticidad	encrucijada	HYPER
alterno	opuesto	ANT
diploide	haploides	ANT
cable	organizar	HYPER
actor	juego	RANDOM
murciélago	material	RANDOM
masticación	comiendo	PART_OF
armario	corto	RANDOM
revestimiento de madera	edificio	PART_OF
vigilancia	atención	HYPER
impotente	potente	ANT
desesperadamente	urgentemente	SYN
espuma	efervescencia	HYPER
medicina	pistola	RANDOM
autor	superficial	RANDOM
pantalones deportivos	sudores	PART_OF
caché	sello	HYPER
centralización	descentralización	ANT
sala	hospital	PART_OF
comenzando	primero	SYN
sayo	túnica	SYN
adquirir	localizar	HYPER
llevar	ver	RANDOM
divinidad	profecía	SYN
cielo	región	HYPER
cristiano	vehículo	RANDOM
artista	guerra	RANDOM
arrepentido	impenitente	ANT
enfermedad	baño	RANDOM
de moda	pasado de moda	ANT
movimiento	ratón	RANDOM
caña	carretón	PART_OF
trimestre	quintal	PART_OF
fiesta	contar	RANDOM
obligatorio	Opcional	ANT
fanfarrón	tempestuoso	SYN
culpa	bendito	SYN
orden	protón	RANDOM
Asia	instrucción	RANDOM
máximo	mínimo	ANT
imparcialidad	parcialidad	ANT
diablo	ortiga	SYN
reloj	mucho	RANDOM
asignación	reunión	HYPER
agrietamiento	ordenado	SYN
regreso	respuesta	HYPER
aire	salir	RANDOM
analista	psicoanalista	SYN
incineración	combustión	HYPER
aumentar	promover	SYN
soja	haba de soja	PART_OF
zumbido	cremallera	HYPER
sardina	calcedonia	HYPER
estator	soplador	PART_OF
mililitro	dl	PART_OF
socorro	socorro	SYN
disparo	Disparo	SYN
rotor	helicóptero	PART_OF
sabor	tono	SYN
pobre	tacaño	SYN
tolerancia	permiso	HYPER
hervir	hervir	SYN
pista	tranvía	PART_OF
circulo	prueba	RANDOM
nártex	Iglesia	PART_OF
manzana	mamífero	RANDOM
falsificar	manipular	SYN
fallecimiento	toda la vida	PART_OF
corcel	montar	HYPER
imperfección	perfección	ANT
noventa	período	HYPER
ancla	garra	HYPER
ciudad	Novia	RANDOM
proa	motos acuáticas	PART_OF
comienzo	graduación	SYN
chile	jalapeño	PART_OF
centrar	suma	SYN
golpear	pecho	RANDOM
restauracion	reparación	HYPER
anual	bienal	ANT
gruñido	distorsionar	HYPER
concentración	dilución	ANT
tía	tío	ANT
chico	derecho	RANDOM
pull-over	prenda	HYPER
úvula	paladar	PART_OF
enrejado	celosía	SYN
falta de pago	pago	ANT
intestino	torso	PART_OF
nube	dormir	RANDOM
aspereza	suavidad	ANT
timo	endocrino	HYPER
comercializador	vendedor	SYN
loca	enojado	SYN
rebajado	elevado	ANT
insoluble	soluble	ANT
competencia	incompetencia	ANT
irreversible	reversible	ANT
cadera	Rosal	PART_OF
caramelo	oscuro	RANDOM
escarola	endibia	PART_OF
Swag	sacudir	HYPER
encuesta	árbol desmochado	SYN
Error	libro	RANDOM
germinación	brotante	SYN
avellana	color avellana	PART_OF
ladrillo rojo	ladrillo rojo	SYN
chorro	delirio	SYN
cárcel	problema	RANDOM
película	RAM	RANDOM
filete	ración	HYPER
constante	inconstante	ANT
estela	eje	PART_OF
comprar	habitación	RANDOM
duplicar	comprobar	HYPER
codicilo	testamento	PART_OF
clementina	agrios	HYPER
bolso	adquirir	HYPER
aventuras	pensar	RANDOM
novato	principiante	HYPER
frívolo	grave	ANT
fácil	mancha	SYN
atribución	atribución	SYN
Bigote	bigotes	PART_OF
capitán	integridad	RANDOM
circular	desplazar	HYPER
soporte	editar	HYPER
mirasol	Helianthus	HYPER
caseoso	cascado	SYN
enredado	desenredado	ANT
ilustrar	ejemplo	SYN
acción	tapa	RANDOM
bulgur	tabulé	PART_OF
puente	sala	RANDOM
dramatizar	embellecer	SYN
secuencia	Foto	PART_OF
considerado	desconsiderado	ANT
afectar a	zanja	SYN
cerebro	infeliz	RANDOM
puente	palabra	RANDOM
aprovechar	tolva	PART_OF
parque	mucho	RANDOM
pierna	mates	RANDOM
cumpleaños	miedo	RANDOM
colina	propina	HYPER
arrendamiento	habitar	RANDOM
alcance	Radar	PART_OF
Irlanda	Huelga	RANDOM
curva	mía	RANDOM
estator	más suave	PART_OF
caña	auricular	PART_OF
asado	cocina	HYPER
papel	planta	RANDOM
Cere	punta	HYPER
avellana	color avellana	PART_OF
borrador	movilización	HYPER
endecha	lamento	SYN
cuenta	sol	RANDOM
3	iii	SYN
chorro	descarga	HYPER
cambio	mano	RANDOM
litro	hectolitro	PART_OF
masa	avalancha	SYN
Kobo	naira	PART_OF
canal	alma	RANDOM
consagrado	profanado	ANT
fuga	práctica	RANDOM
volante fruncido	molestar	HYPER
semilla de algodón	algodón	PART_OF
amigo	amigote	SYN
admirar	isla	RANDOM
No tradicional	tradicional	ANT
exterior	nativo	ANT
íntimo	sugerir	SYN
embellecer	bordar	SYN
media	poema	RANDOM
cabestro	aprovechar	PART_OF
eje	edificio	PART_OF
emperador	nymphalid	HYPER
interpretable	injugable	ANT
justa	injusto	ANT
disturbio	combate	HYPER
jugoso	al rojo vivo	SYN
saltador	columnata	PART_OF
infraestructura	sistema	PART_OF
montaña	saltar	RANDOM
aguachirle	bazofia	SYN
inferior	padre	RANDOM
andar de forma vacilante	desfallecer	SYN
polémico	incontrovertible	ANT
bufonada	payasadas	SYN
soplar	solución	RANDOM
visa	pasaporte	PART_OF
bar	presente	RANDOM
comino	metálico	HYPER
matriz	hueso	PART_OF
interferencia	no interferencia	ANT
galón	trimestre	PART_OF
herbívoro	insectívoro	ANT
grieta	modificación	HYPER
avión	difícil	RANDOM
temprano	tarde	ANT
alcohólico	no alcohólico	ANT
jinete	medida	PART_OF
pantalla de lámpara	lámpara	PART_OF
grande	sol	RANDOM
transparente	transparente	SYN
físico	alguien	PART_OF
habló	ciclo	PART_OF
desnudez	franqueza	SYN
recitación	curso	PART_OF
antiguo	sonar	RANDOM
nudo	álbum	RANDOM
picar	dolor	HYPER
exhaustivo	completo	SYN
almuerzo	ascensor	RANDOM
trono	vivienda	PART_OF
bañera	energético	RANDOM
saburral	sin revestir	ANT
réplica	estocada	SYN
lectura concienzuda	hojeando	SYN
asdic	submarino	PART_OF
lente	enfurecer	RANDOM
directo	indirecto	ANT
agujero	intacto	RANDOM
calzada	autopista	PART_OF
biotecnología	ergonomía	SYN
proponer	declarar	HYPER
masticar	pasado	RANDOM
chocolate	abajo	RANDOM
murciélago	trabajo	RANDOM
reloj	tarro	RANDOM
coche	elemento	RANDOM
monetizar	legitimar	HYPER
bloqueo	obstruir	SYN
portero	porque	HYPER
impaciencia	paciencia	ANT
midi	mini	ANT
parilla	picnic	HYPER
lona	fondo	HYPER
carmín	cereza	SYN
escabullen	velocidad	HYPER
imperial	púrpura	SYN
taro	taro	PART_OF
asegurado	sin seguro	ANT
de repuesto	parte	HYPER
mancha	óculo	PART_OF
caza	molestia	SYN
pendiente descendente	inclinación	HYPER
hecho a medida	confeccionado	ANT
costura	sin costura	ANT
organizar	peinado	SYN
masticando	masticación	HYPER
archiduquesa	princesa	HYPER
muñeca	brazo	PART_OF
acompañamiento	asistente	SYN
eficiencia	ineficacia	ANT
cáncer	deporte	RANDOM
osteópata	experto	HYPER
civilización	familia	RANDOM
diván	salón	HYPER
heterosexual	escenario	RANDOM
silla	canción	RANDOM
popularidad	impopularidad	ANT
ayuda	cueva	RANDOM
corneum	cutícula	PART_OF
Al por menor	venta al por mayor	ANT
oficialmente	no oficial	ANT
pasillo	hierba	RANDOM
30	xxx	SYN
sombreada	sin sombra	ANT
anular	reinado	HYPER
arenoso	guaperas	SYN
batallón	pluralidad	SYN
tapa	fingir	RANDOM
escuela	infraestructura	PART_OF
débil	síncope	SYN
abrazando	apretar	HYPER
valiente	lugar	RANDOM
atonal	tonal	ANT
descubrimiento	destapando	SYN
pasillo	contratar	RANDOM
juez	recreo	RANDOM
sazonado	sin sazonar	ANT
fábula	leyenda	SYN
envase	artefacto	HYPER
figura	alguien	PART_OF
seno	prenda	PART_OF
elástico	no elástico	ANT
vulva	partes pudendas	HYPER
bufonesco	clownesco	SYN
conocido	desconocido	ANT
manzana	enviar	RANDOM
divisible	indivisible	ANT
sector	bloquear	PART_OF
baloncesto	lejos	RANDOM
anexo	adición	HYPER
mentira	vehículo	RANDOM
distorsionar	tinte	SYN
conciencia de sí mismo	conocimiento	HYPER
aquí	ahí	ANT
canal	valores	RANDOM
compresión	descompresión	ANT
enterrar	laico	HYPER
guiado	sin guía	ANT
integración	segregación	ANT
gaviota	traicionar	HYPER
barco	ideología	RANDOM
haba de soja	soja	PART_OF
caja	límite	PART_OF
asumiendo	presuntuoso	SYN
harpillera	despido	SYN
lírica	nivel	RANDOM
citocinesis	mitosis	PART_OF
honestidad	iluminar	RANDOM
exterior	interior	ANT
supresor	gene	HYPER
cerrar	evitar	HYPER
cumpleaños	democracia	RANDOM
río abajo	río arriba	ANT
tentación	influencia	HYPER
anticuado	arcaico	SYN
pico	escala	RANDOM
lesionar	árbol	RANDOM
primer plano	puntuar	HYPER
máquina	matar	RANDOM
derrota	retirar	HYPER
pérfido	traicionero	SYN
alterno	suplente	SYN
miembro	positivo	RANDOM
calzoncillos	pantys	PART_OF
casi	cerca	SYN
gordura	flacura	ANT
eliminar	lanzamiento	HYPER
slickness	astucia	SYN
contener	inhibir	HYPER
lona	lona	HYPER
aceptación	rechazo	ANT
capacidad	circuito	PART_OF
coherencia	incoherencia	ANT
sangre roja	rubicundo	SYN
reloj	escupir	RANDOM
regazo	prenda	PART_OF
período	Eón	PART_OF
brezal	yermo	HYPER
abierto	franco	SYN
telescopio	aplastar	HYPER
empujoncito	pandilla	RANDOM
Oceano	angustia	RANDOM
risita	declaración	HYPER
singularidad	individualismo	HYPER
enfermedad	suelo	RANDOM
mandíbula	arrojar	PART_OF
antimicrobiano	desinfectante	SYN
independencia	cabeza	RANDOM
kilovatio	megavatio	PART_OF
nacimiento	arma	RANDOM
cráneo	caput	PART_OF
borrador	parte	HYPER
antagonista	conciliador	ANT
bolígrafo	RAM	RANDOM
mayoria	minoría	ANT
blooper	metedura de pata	SYN
poco práctico	práctico	ANT
ascenso	descendencia	ANT
monzón	caída	HYPER
cardenal	central	SYN
arb	burgués	HYPER
canción de cuna	vocal	HYPER
saboreando	alimentación	HYPER
incisión	cirugía	PART_OF
gasa	parche	PART_OF
bonanza	ganancia inesperada	SYN
terror	pícaro	HYPER
endurecer	comprobar	HYPER
contrarrevolucionario	revolucionario	ANT
gramo	hg	PART_OF
flexible	plataforma	PART_OF
mango	marca	PART_OF
limón	amarillo	HYPER
milímetro	cm	PART_OF
pelota	casar	RANDOM
endogamia	exogamia	ANT
hoja	gritar	RANDOM
rayo de luna	luz de la luna	PART_OF
blanco	huevos	PART_OF
extremidades	sin extremidades	ANT
lápida mortuoria	lápida sepulcral	SYN
torpe	agraciado	ANT
líquido	vuelo	RANDOM
naranja china	naranja china	PART_OF
hueco	prisión	RANDOM
índice	jugar	RANDOM
ochenta	vejez	PART_OF
perezoso	rango	RANDOM
geminado	desplazar	HYPER
acosar	molestar	SYN
aceleración	gestación	PART_OF
agujereado	apretado	ANT
tizón	golpear	HYPER
mapa	lado	RANDOM
cuarto	trimestre	SYN
vida	trabajo	RANDOM
médula	suma	SYN
paga	jugar	RANDOM
clase media	clase alta	ANT
cazar	dorar	HYPER
general	específico	ANT
tocón	enrejado	PART_OF
al través	longitudinal	ANT
glorioso	ignominioso	ANT
novio	apretón	RANDOM
hemorrágico	hemorrágico	SYN
autoritario	clásico	SYN
aburrimiento	cultura	RANDOM
diorama	panorama	SYN
AVE acuática	aves acuáticas	SYN
crystalized	glaseado	SYN
creencia	humano	RANDOM
compartimiento	hoja	RANDOM
adecuadamente	inadecuadamente	ANT
fabricante	preocupación	HYPER
copla	pareja	SYN
cáscara	tallo	SYN
anacardo	anacardo	PART_OF
llave	azúcar	RANDOM
reconstruir	evaluar	HYPER
medicina	cadena	RANDOM
instalación	entrega	SYN
cm	dm	PART_OF
endogámico	exógamo	ANT
mandarín	mandarín	PART_OF
interdependencia	mutualidad	SYN
burlón	burlas	SYN
honor	posición	HYPER
ligamento	musculatura	PART_OF
terminado	inconcluso	ANT
montón de chatarra	cúmulo	HYPER
canguelo	retroceso	SYN
maricón	bordar	HYPER
mercurio	bosque	RANDOM
fidelidad	infidelidad	ANT
intangible	tangible	ANT
falsificación	auténtico	ANT
huesos	chapaletas	SYN
desestructurado	organizado	ANT
disponibilidad	indisponibilidad	ANT
mutuo	recíproco	SYN
vale	seguidor	HYPER
plural	singular	ANT
hendido	disecado	SYN
articular	suministro	HYPER
mordaz	amargo	SYN
batata	batata	PART_OF
hueco	esqueleto	RANDOM
piedra clave	arcada	PART_OF
cómico	cómic	SYN
negar	negar	HYPER
desproporción	proporción	ANT
exclusivamente	solamente	SYN
caja de cambios	caso	HYPER
ingrávido	pesado	ANT
resistencia	chasquido	HYPER
lograr	alcanzar	SYN
inhalación	respiración	PART_OF
gauss	tesla	PART_OF
deferencia	civilidad	HYPER
pentobarbital	barbitúrico	HYPER
director de escuela	préstamo	PART_OF
insolación	terapia	HYPER
apuesta	especulación	HYPER
quejas	retumbante	SYN
reducción	longitud	HYPER
facial	caput	PART_OF
pelota	aguja	RANDOM
cinturón de seguridad	avión de línea	PART_OF
celofán	envase	HYPER
bolígrafo	muerte	RANDOM
tarea pesada	trabajo ligero	ANT
camisa de entrenamiento	sudadera	PART_OF
gris	oso pardo	SYN
entarimado	automóvil	PART_OF
palillo de tambor	ave	PART_OF
marca	sin marca	ANT
cabalgada	procesión	HYPER
aah	expresar verbalmente	HYPER
afortunado	desgraciado	ANT
queso de cerdo	fuerza	HYPER
ateísmo	teísmo	ANT
generar	hacer	SYN
cáliz	florecer	PART_OF
calzada	thruway	PART_OF
limpiar	clima	RANDOM
periodista	periodista	HYPER
corazón frío	warmhearted	ANT
nacimiento	hora	RANDOM
transportador	fábrica	PART_OF
querido	precioso	SYN
cestería	arte	HYPER
nuevo	techo	RANDOM
tinta	bosque	RANDOM
ceñido	sin cinturón	ANT
perdió	salvado	ANT
maillot	traje de baño	HYPER
otoñal	vernal	ANT
bañera	perra	RANDOM
bodega	congelar	RANDOM
bolígrafo	lluvia	RANDOM
Perilla de la puerta	edificio	PART_OF
existencia	no existencia	ANT
apuesta	piscina	PART_OF
ilegitimidad	legitimidad	ANT
uña del dedo del pie	pes	PART_OF
audible	inaudible	ANT
perturbador	perturbador	SYN
cuerpo	enlazar	RANDOM
techo	instrumento	RANDOM
comparable	incomparable	ANT
miope	miope	SYN
trabajo preparatorio	explicación	PART_OF
modelo	bipedestador	ANT
intratable	manejable	ANT
rumia	poco	HYPER
cuerpo	derecho	RANDOM
acetaminofeno	medicación	HYPER
mercado	puntada	RANDOM
Perfecto	cigarrillo	RANDOM
silaba	mensaje	HYPER
dormido	despertarse	ANT
hélice	espira	SYN
armamento	desarmamiento	ANT
paga	jugo	RANDOM
BOD	alguien	PART_OF
béisbol	movimiento	RANDOM
regular	razonablemente	SYN
embellecer	almohadilla	SYN
ignorancia	plato	RANDOM
primero	clase mundial	SYN
período previo	bolos	PART_OF
geográfico	magnético	ANT
Cálamo	plumaje	PART_OF
escándalo	pelea	SYN
inmersión	comienzo	HYPER
patriótico	antipatriótico	ANT
a la deriva	sin objetivo	SYN
cuenta	expandir	RANDOM
quintal	quintal	PART_OF
acortar	dama	RANDOM
invulnerabilidad	vulnerabilidad	ANT
degeneración	proceso	HYPER
eficientemente	ineficientemente	ANT
gángster	director de escuela	HYPER
resultado	ido	SYN
lb	trimestre	PART_OF
extranjero	viajero	HYPER
mango	daga	PART_OF
ocupado	cortar con tijeras	RANDOM
mayal	solapa	HYPER
accidentalmente	deliberadamente	ANT
valiente	el plastico	RANDOM
procesador	plataforma	PART_OF
pálido	fuera de	RANDOM
lapso	pareja	SYN
rayo	re	SYN
multilateral	unilateral	ANT
elaborar cerveza	impregnar	HYPER
laurel	coronal	HYPER
miseria	útil	RANDOM
aprender	planta	RANDOM
jefe	ingrediente	RANDOM
veintiuna	presión	SYN
cosa análoga	término análogo	SYN
pista	tránsito	PART_OF
imágenes	imágenes	SYN
desencadenar	palanca	HYPER
artificial	sintético	SYN
equilibrar	sala	RANDOM
años	toda la vida	PART_OF
cerca	Esgrima	SYN
fraternal	fraternal	ANT
orégano	orégano	PART_OF
estante	buffet	PART_OF
blanqueador	porque	HYPER
pobre	Rico	ANT
lineal	no lineal	ANT
crédito	débito	ANT
certeza	incertidumbre	ANT
colina	evento	RANDOM
carta	nuevo	RANDOM
montaje	desmontaje	ANT
escote	suéter	PART_OF
biblioteca	fabricar	RANDOM
reportado	no declarada	ANT
atestiguado	autenticado	SYN
vejez	toda la vida	PART_OF
irritacion	dolor	SYN
satisfactorio	insatisfactorio	ANT
multiculturalismo	nacionalismo	ANT
ovíparo	ovoviviparous	ANT
esnobismo	hauteur	HYPER
explícito	implícito	ANT
velo	matriz	PART_OF
Wainwright	artífice	HYPER
arrecife	vela	PART_OF
melindroso	exigente	SYN
novio	extraño	RANDOM
hecho	mediante	SYN
deflación	inflación	ANT
insinuación	tinte	SYN
medianoche	Noche	PART_OF
centavo	rand	PART_OF
matrimonio	plano	RANDOM
naranja	abierto	RANDOM
cuentista	hablador	HYPER
suburbio	franja	PART_OF
inseguridad	seguridad	ANT
navegar	tabla de surf	SYN
medio	insecto	RANDOM
freza	pelea	SYN
líquido	limpiar	RANDOM
veleta	flecha	PART_OF
transparente	escarpado	SYN
azufre	impacto	HYPER
cebo	estafermo	SYN
familiar	hereditario	SYN
mortal	pernicioso	SYN
picar	marca	RANDOM
dilatorio	lento	SYN
molar	molecular	ANT
fácil	difícil	ANT
tripulado	no tripulado	ANT
Australia	mano	RANDOM
frente a	manga	PART_OF
burla	burla	SYN
inconscientemente	sabiendas	ANT
vacío	plenitud	ANT
bar	petróleo	RANDOM
anfotericina	antibiótico	HYPER
capacidad	incapacidad	ANT
disparo a la cabeza	Foto	HYPER
capítulo	rascacielos	RANDOM
irrespetuosamente	respetuosamente	ANT
aumentar	informar mal	HYPER
adoptado	nativo	ANT
milímetro	centímetro	PART_OF
recuperación	rescate	HYPER
civilidad	incivilidad	ANT
agitado	creciente	HYPER
circulo	tornillo	RANDOM
marcha	mal funcionamiento	ANT
pantalones de cuero	pantalones cortos	HYPER
autónomo	independiente	SYN
asta de bandera	asta de bandera	SYN
metanfetamina	shabu	SYN
veterinario	veterinario	SYN
anormal	normal	ANT
lío	avalancha	SYN
majadero	batería	PART_OF
boca	débiles	RANDOM
bigotes	homo	PART_OF
paga	mosca	RANDOM
revés	derechazo	ANT
convencionalmente	no convencional	ANT
cerebro	arriba	RANDOM
beneficio	mie	RANDOM
vacío	vacante	SYN
maravillosamente	maravillosamente	SYN
decisión	indecisión	ANT
masoquista	sádico	ANT
bota	crear	RANDOM
lychee	lychee	PART_OF
esfera	región	HYPER
armado	desarmado	ANT
mezcla	agravando	HYPER
saqueo	robo	SYN
subestimar	concebir	HYPER
potable	imbebible	ANT
tailplane	empenaje	PART_OF
barf	vómito	SYN
arrendamiento	cable	RANDOM
presa	mermelada	HYPER
inquilino	habitante	HYPER
coartada	defensa	HYPER
pose	vejar	SYN
tapa	espíritu	RANDOM
sin hogar	apátrida	SYN
verduras	hierba	PART_OF
capitán	vertical	RANDOM
franco	excusa	HYPER
subsistencia	siendo	HYPER
travesaño	poste de la meta	PART_OF
pequeño	comercio	RANDOM
Marco principal	plataforma	PART_OF
gubia	victimizar	HYPER
Aparecer	película	RANDOM
quiropráctico	experto	HYPER
paso	corriendo	ANT
solidificación	plastinación	PART_OF
noray	muelle	PART_OF
almuerzo	engañar	RANDOM
bicicleta	enfermos	RANDOM
cumpleaños	pistola	RANDOM
ropa	mercancía	HYPER
bruto	red	ANT
grava	pose	SYN
milicia	reservas	SYN
sone	phon	PART_OF
noble	aristócrata	ANT
firme	ruta	PART_OF
proteger	mariscos	PART_OF
no fumador	fumador	ANT
coto	struma	SYN
autor	entretenimiento	RANDOM
de reunión	montaje	HYPER
favorito	privilegiado	SYN
escalera	edificio	PART_OF
maldad	bondad	ANT
pediatra	médico	HYPER
bisexual	heterosexual	ANT
estuario	estuario	HYPER
casa	estrés	RANDOM
hipermétrope	miope	ANT
reflejar	manifiesto	HYPER
ordinario	blanco	RANDOM
parque de atracciones	tracto	HYPER
dormido	despertarse	ANT
pantanoso	pantanoso	SYN
Impacientemente	pacientemente	ANT
gancho	recargo	SYN
aguja	cartucho	PART_OF
igualmente	de manera desigual	ANT
tierras bajas	meseta	ANT
superestrella	fenómeno	SYN
avanzar	retirada	ANT
vado	corriente	PART_OF
pegajoso	cursi	SYN
atributivo	predicativo	ANT
precoz	retrasado	ANT
Chon	won	PART_OF
hermosa	Universidad	RANDOM
estrógeno	estrógeno	SYN
lealtad	lealtad	SYN
conformidad	disconformidad	ANT
severo	mordaz	SYN
caña	motos acuáticas	PART_OF
ingenuo	sofisticado	ANT
sofocante	bochornoso	SYN
cromático	diatónico	ANT
sal	Listo	HYPER
folleto	carpeta	SYN
doble	tarjetas	PART_OF
probable	alguien	HYPER
armar	puerta	RANDOM
ovíparo	vivíparo	ANT
yang	yin	ANT
cromatina	núcleo	PART_OF
pulposo	sensiblero	SYN
exposición	fotografía	HYPER
impresionante	impresionante	ANT
nación	raro	RANDOM
estimular	equipar	HYPER
parte	lucro	PART_OF
asi que	Sol	SYN
ciego	de vista normal	ANT
líquido	enviar	RANDOM
billar	piscina	PART_OF
irritar	impacto	HYPER
cutícula	molusco	PART_OF
becerro	enviar	RANDOM
carril	balaustrada	PART_OF
objeto	constelación	RANDOM
burlesco	farsa	SYN
intención	intención	SYN
pueblo	municipio	HYPER
aprehender	comprensión	SYN
lingual	lingüístico	SYN
probatorio	probatorio	SYN
equipado	sin equipo	ANT
revitalizar	recrear	HYPER
comba	hipocresía	SYN
estopilla	gasa	HYPER
imposibilidad	posibilidad	ANT
regatear	goteo	SYN
roedor	mamífero	HYPER
51	li	SYN
manchar	mancha	SYN
azul	ignorancia	RANDOM
morph	distorsionar	HYPER
cl	decilitro	PART_OF
iluminación	equipo	HYPER
mezcla	mezclando	SYN
cambiar	modificación	HYPER
Japón	extinguir	RANDOM
líder	enjuiciamiento	RANDOM
aleta de la cola	decoración	HYPER
gradual	escarpado	ANT
clausura	apertura	ANT
exitosamente	sin éxito	ANT
guirnalda	Lei	SYN
abucheo	ulular	SYN
centavo	chelín	PART_OF
cobertura	esquivar	SYN
trasero	derriere	SYN
desincentivo	incentivo	ANT
matrimonio	ratón	RANDOM
flota	ir	HYPER
aversión	inclinación	ANT
mostrador	domicilio	PART_OF
fuga	cortar con tijeras	RANDOM
mermelada	taco	SYN
curva	dama	RANDOM
fanático	demasiado entusiasta	SYN
diafragma	cámara	PART_OF
impregnar	tintura	SYN
menguante	depilación	ANT
justificar	modificar	HYPER
montaña	cortar con tijeras	RANDOM
brazo	munición	PART_OF
objetividad	juicio	HYPER
canabis	gira	RANDOM
oportunidad	riesgo	SYN
Oceano	Hobby	RANDOM
conspirador	director de escuela	HYPER
tendón	musculatura	PART_OF
fortísimo	pianísimo	ANT
ácido	amargo	SYN
aprender	carta	RANDOM
filial	de los padres	ANT
abortar	terminación	HYPER
Bastardo	ilegítimo	SYN
accidente	fin	RANDOM
encarnar	expresar verbalmente	HYPER
máximo	mínimo	ANT
formalizado	formalizado	SYN
impulso	consejo	HYPER
aire-aire	superficie-a-aire	ANT
Cinque	quinteto	SYN
montón	apilar	SYN
sequedad	humedad	ANT
borracho	borracho	SYN
espíritu	potable	HYPER
calibre	estandarizar	HYPER
trocánter	fémur	PART_OF
colaborador	secuaz	SYN
profanación	sacrilegio	SYN
campo	cuenco	PART_OF
terrible	horrendo	SYN
hombre musculoso	agresor	HYPER
caldera	buque de vapor	PART_OF
republicar	renovar	HYPER
conjuntiva	párpado	PART_OF
benevolencia	malevolencia	ANT
acuerdo	gallo	RANDOM
nación	escritor	RANDOM
media	espectáculo	RANDOM
obstruir	mermelada	HYPER
formado	desformado	ANT
colina	lavar	RANDOM
Plaga	imposición	HYPER
prematuro	anterior	SYN
libresco	estudioso	SYN
vigor	vigor	SYN
incisión	operación	PART_OF
kilo	kilogramo	SYN
me gusta	trampa	RANDOM
ventrículo	caput	PART_OF
alta velocidad	alta velocidad	SYN
saltar	puntada	RANDOM
rotonda	ruta	PART_OF
cuarteto	cuaternario	SYN
cábala	Kabala	SYN
mezcla	vivir	RANDOM
correctamente	incorrectamente	ANT
barato	costoso	ANT
carrera	velocidad	HYPER
nuevo	derecho	RANDOM
claridad	oscuridad	ANT
arrendamiento	nuevo	RANDOM
esperanza	casa	RANDOM
favorable	desfavorable	ANT
racionar	límite	HYPER
canabis	miseria	RANDOM
centavo	lempira	PART_OF
bestial	infernal	SYN
medio litro	picotear	PART_OF
incrementar	estudiar	RANDOM
enganche	frotar	SYN
rapé	afilar	PART_OF
armadura	suministro	HYPER
desconfiado	confiado	ANT
caballo	tropas	HYPER
personalizar	personalizar	SYN
pasado	resultado	SYN
biblioteca	línea	RANDOM
año	siglo	PART_OF
tipi	vivienda	HYPER
gaulteria	gaulteria	PART_OF
centrómero	núcleo	PART_OF
Complementario	uncomplimentary	ANT
lápida mortuoria	tumba	PART_OF
autor	creador	HYPER
espíritu	embriagante	HYPER
flanco	cuadrúpedo	PART_OF
corola	periantio	PART_OF
no profesional	profesional	ANT
destello	largarse	SYN
masticación	comiendo	PART_OF
ocular	monumentos	PART_OF
carril	ferrocarril	PART_OF
tope	mástil	PART_OF
bebé	agua	RANDOM
estrago	azotar	SYN
premisa	presumir	HYPER
capucha	flora	PART_OF
tornillo	lento	RANDOM
a dos aguas	a cuatro aguas	ANT
meandro	corriente	PART_OF
sibilante	fricativa	HYPER
recalentar	modificar	HYPER
creer	concebir	SYN
canal	transmitir	SYN
cobardemente	temeroso	SYN
limitado	ilimitado	ANT
cráneo	bestia	PART_OF
debate	conversar	HYPER
salón	pub	PART_OF
accidente	pescado	RANDOM
inmoral	moral	ANT
sofocante	sulfuroso	SYN
heterogéneo	homogéneo	ANT
masticar	lavar	RANDOM
Perfecto	ratón	RANDOM
irresponsabilidad	responsabilidad	ANT
coherente	incoherente	ANT
agujero	sello	RANDOM
ovario	angiosperma	PART_OF
repelente	asqueroso	SYN
conservador	liberal	ANT
precursor	predecesor	SYN
ineludible	inevitable	SYN
isquion	muslo	PART_OF
cristiano	canta	RANDOM
desembarco	embarque	ANT
defensiva	ofensivamente	ANT
quintal	tonelada	PART_OF
consecutivo	sucesivo	SYN
actividad	inactividad	ANT
cita	mediación	HYPER
municipio	distrito	HYPER
aprender	malo	RANDOM
llave	enorme	RANDOM
Patsy	ventosa	SYN
poder	capaz	SYN
escritura	actividad	HYPER
delicioso	al rojo vivo	SYN
remediador	terapéutico	SYN
personalidad	alguien	PART_OF
lápida mortuoria	columnata	PART_OF
irritante	fastidiándote	SYN
inadmisible	permisible	ANT
pregonero	vendedor ambulante	HYPER
puerto	proteger	SYN
carne de caballo	caballo	PART_OF
atractivo	poco atractivo	ANT
tul	malla	HYPER
esquina	edificio	PART_OF
angstrom	nanómetros	PART_OF
bemusement	mistificación	SYN
componer	constituir	HYPER
esquilador	hombre trabajador	HYPER
insuficiencia	suficiencia	ANT
heterodino	mezclarse	HYPER
ocasión	ocurrencia	HYPER
prefacio	publicación	PART_OF
Giro de vuelta	ruta	PART_OF
requisición	apropiación	HYPER
ciclo	kilohercio	PART_OF
irregular	regular	ANT
Maven	sensación	SYN
botón	dulce	RANDOM
defensa	motor	PART_OF
llave	contaminar	RANDOM
centavo	Córdoba	PART_OF
mal comportamiento	marcha mala	HYPER
inflamación	astillas	SYN
vencimiento	respiración	PART_OF
nuca	cerviz	PART_OF
tríada	agregación	HYPER
femenino	masculino	ANT
escaso	apenas	SYN
evaluar	medida	SYN
divinidad	adivinar	HYPER
mamífero	Halar	RANDOM
cavar	fuerza	HYPER
asalto	embestida	PART_OF
especial	universal	ANT
prostituta	director de escuela	HYPER
idioma	pan	RANDOM
condición	proceso	HYPER
ascendiente	dominio	SYN
realeza	pago	HYPER
escrupuloso	poco escrupuloso	ANT
monitor	me gusta	RANDOM
góndola	dirigible	PART_OF
directamente	indirectamente	ANT
empujoncito	mentira	RANDOM
prohibición	exigir	HYPER
regate	falsedad	HYPER
fase	ritmo	PART_OF
engendrar	desovar	SYN
invisibilidad	visibilidad	ANT
carnívoro	herbívoro	ANT
pendiente	collar	PART_OF
capaz	incapaz	ANT
engañador	malhechor	HYPER
ciudad	material	RANDOM
ampolla	canal	PART_OF
temblar	emoción	SYN
adecuación	insuficiencia	ANT
independencia	músculo	RANDOM
conservatorio	edificio	HYPER
a menudo	raramente	ANT
a flote	encallado	ANT
empeñar	asistente	HYPER
llamativo	deportivo	SYN
llamada	resbalón	RANDOM
campeonato	título	SYN
agresor	instigador	HYPER
escudo	trimestre	PART_OF
involuntario	Witting	ANT
burgués	conservador	SYN
calamares	calamar	PART_OF
incubación	período	HYPER
manchada	intachable	ANT
velo	útero	PART_OF
canario	vocalista	HYPER
consuntivo	generativo	ANT
continuidad	discontinuidad	ANT
engañar	envase	RANDOM
enérgico	azotaina	SYN
obstruido	sin obstáculos	ANT
objeto	Gol	RANDOM
resistir a	contender	HYPER
pegar	dispersión	HYPER
negativo	neutral	ANT
proscrito	verboten	SYN
memorable	sin acontecimientos notables	ANT
restringido	irrestricto	ANT
promover	nombrar	HYPER
tratar	sonda	HYPER
obra	publicación	PART_OF
tomando embutido	cuña	SYN
movimiento	piso	RANDOM
subtítulo	versión	HYPER
pico	superior	RANDOM
superego	inconsciente	PART_OF
intersección	unión	HYPER
aclamación	mensaje	HYPER
exigente	poco exigente	ANT
aligerar	alegrarse	HYPER
ortodoxo	heterodoxo	ANT
bienal	perenne	ANT
aprender	sensación	RANDOM
aturdido	confuso	SYN
apreciación	depreciación	ANT
florecer	información	RANDOM
gravitación	levitación	ANT
conformidad	incumplimiento	ANT
heroísmo	valor	SYN
nuevo	basura	RANDOM
pubis	pelvis	PART_OF
deshonroso	honorable	ANT
megabit	gigabit	PART_OF
imprecisa	precisamente	ANT
engañar	reproducción	RANDOM
contenido	desenfrenado	ANT
brazo	brazos	PART_OF
ceremonialmente	ritualmente	SYN
ascendente	descendente	ANT
pentatleta	concursante	HYPER
hervir	dirigir	RANDOM
cristalino	límpido	SYN
bar	salón	PART_OF
favorito	elección	HYPER
Perfecto	traer	RANDOM
ante todo	principalmente	SYN
significativo	sin sentido	ANT
fidelidad	infidelidad	ANT
Mira	transporte	RANDOM
fusión	combinatorio	HYPER
rallar	estufa	PART_OF
reservas	acumulación	HYPER
galón	bushel	PART_OF
cómodamente	incómodamente	ANT
físico	alguien	PART_OF
Organo	detalle	RANDOM
pedal	ciclo	PART_OF
destino	sobrenatural	PART_OF
nudo	actor	RANDOM
garra del insecto	crustáceo	PART_OF
vendaje	fertilización	SYN
asignación	prorrateo	SYN
conformista	inconformista	ANT
médula	OS	PART_OF
desconexión	Golfo	SYN
saturación	plastinación	PART_OF
imparcialidad	parcialidad	ANT
protegido	desprotegido	ANT
fragua	Progreso	HYPER
microsegundo	s	PART_OF
impío	malvado	SYN
pico	ciudad	RANDOM
abuso de autoridad	marcha mala	HYPER
sin sentido	perder el tiempo	HYPER
bañista	porque	HYPER
humanidad	resultado	RANDOM
picar	despierto	RANDOM
dualidad	arreglo	HYPER
parque	dulce	RANDOM
decir algo	ajetreo	SYN
atleta	idea	RANDOM
pedir	necesitar	SYN
culo	torso	PART_OF
conjugación	unión	SYN
confederación	conspiración	SYN
cruce	corriente de agua	PART_OF
composición	constitución	SYN
lleno de pánico	aterrorizado	SYN
molesto	Bienvenido	ANT
cansancio	cansancio	SYN
baloncesto	maíz	RANDOM
cadera	cadera	PART_OF
pestaña	óptico	PART_OF
mosaico	cámara	PART_OF
lesionar	retirar	RANDOM
carne de vaca	vagón	RANDOM
agresividad	enemistad	HYPER
sesenta	vejez	PART_OF
ligne	en	PART_OF
mango	acero	PART_OF
objeto	llenar	RANDOM
Igualmente	desigualmente	ANT
neurólogo	especialista	HYPER
rotor	soplador	PART_OF
tablón	plataforma	PART_OF
afable	amable	SYN
córnea	óptico	PART_OF
entresemana	semana	PART_OF
resplandor	ocurrencia	HYPER
nacimiento	granja	RANDOM
ocupado	sencillo	RANDOM
acelerador	avión	PART_OF
hokey	artificial	SYN
pliegue	flexura	SYN
apoyo	aprobación	HYPER
ficticio	fingido	SYN
coche	disfrute	RANDOM
empobrecimiento	privación	HYPER
puntuaciones	pilas	SYN
granate	hebra	SYN
apuntalar	ajuste	PART_OF
atraer	invitación	HYPER
adolescente	Adolescente	SYN
Irlanda	maíz	RANDOM
facilitar	reposo	SYN
mandíbula	sin mandíbula	ANT
mayoria	minoría	ANT
camiseta	matriz	PART_OF
teclado	tarro	RANDOM
eficiencia	ineficacia	ANT
reemplazo	reemplazando	SYN
masculino	neutro	ANT
minuto	mentira	RANDOM
volumen	blandura	ANT
degenerar	soltar	SYN
pene	alma	RANDOM
romano	fuente	HYPER
silencioso	todavía	SYN
bicicleta	ignorancia	RANDOM
golpear	Oceano	RANDOM
pasado	diseño	RANDOM
igualdad	invariancia	HYPER
medio siglo	siglo	PART_OF
cargador	mercante	SYN
paisa	rupia	PART_OF
fibra	alguien	PART_OF
rejilla	estufa	PART_OF
rompehielos	motos acuáticas	HYPER
frente	caput	PART_OF
disminución	mejora	ANT
centímetro	metro	PART_OF
anuncio	anuncio	SYN
brillante	maduro	RANDOM
decencia	indecencia	ANT
detrás	torso	PART_OF
remolino	vórtice	SYN
centralización	descentralización	ANT
competitividad	agresividad	HYPER
salida	empresa	HYPER
oferta	difícil	ANT
media Luna	año	PART_OF
sr	esfera	PART_OF
largo	prolongado	SYN
moderación	sucediendo	HYPER
añadir	cascada	RANDOM
rectificar	convertir	HYPER
presunción	humildad	ANT
escotilla	apertura	PART_OF
elegible	inelegible	ANT
pinger	sub	PART_OF
cura	tratamiento	PART_OF
agujas del reloj	sinistrórsum	ANT
nadir	cenit	ANT
corredor desnudo	alguien	HYPER
truncar	truncado	SYN
investigación	interrogatorio	SYN
ceramista	lanzador	SYN
aterrizaje	puerto	PART_OF
arrastrarse	adular	SYN
vomitar	cobertizo	SYN
digresión	desviación	SYN
homosexual	uno	RANDOM
pectoral	torso	PART_OF
inactividad	facilitar	HYPER
clítoris	vulva	PART_OF
Furlong	liga	PART_OF
humildad	unirse	RANDOM
ab	vientre	PART_OF
diana	señalización	HYPER
niño	fiesta	RANDOM
antiguo	lujoso	RANDOM
núcleo	punto	RANDOM
irrelevancia	pertinencia	ANT
samba	fundirse	HYPER
conjurar	remover	SYN
esfenoides	caput	PART_OF
dominador	sumiso	ANT
valiente	descendencia	RANDOM
impetuoso	tearaway	SYN
sucio	mugriento	SYN
ilegítimamente	ilícitamente	SYN
estabilizador	fuselaje	PART_OF
nominativo	oblicuo	ANT
mejilla	torso	PART_OF
cesto	ligado	HYPER
valor	inutilidad	ANT
piña	piña	PART_OF
baño	incrementar	RANDOM
accesibilidad	inaccesibilidad	ANT
orinar	lanzamiento	HYPER
ayuda	querer	RANDOM
tensor	variable	HYPER
docente	educador	HYPER
pasillo	odio	RANDOM
irresponsable	responsable	ANT
calzada	Autopista	PART_OF
deshonrosamente	honradamente	ANT
peldaño	límite	PART_OF
puntiagudo	inútil	ANT
patada	abstenerse de	HYPER
alto	anticiclón	PART_OF
humanidad	ilustración	RANDOM
latón	autoridades	PART_OF
cristiano	corto	RANDOM
astucia	superioridad	HYPER
hospitalización	estado	HYPER
acortar	hora	RANDOM
bulimia	trastornado	HYPER
lat	torso	PART_OF
porcentaje	lucro	PART_OF
hockey	hacer	RANDOM
adivinar	juez	SYN
monitor	fluir	RANDOM
reloj	restringir	RANDOM
máquina	untado	RANDOM
equilibrar	contabilidad	PART_OF
vagina	coño	PART_OF
ruido	conectar	RANDOM
contratado	expandido	ANT
blooper	flub	SYN
barbilla	caput	PART_OF
período	era	PART_OF
fuerza	debilidad	ANT
casa	realizar	RANDOM
Japón	puntada	RANDOM
Organo	ventana	RANDOM
agitación	irritabilidad	SYN
torrente	montón	HYPER
vislumbrar	aspecto	HYPER
aparejo	semi	SYN
pentáculo	pentangle	SYN
saliva	humor	HYPER
bisagra	edificio	PART_OF
desánimo	ánimo	ANT
pozo de mina	mina de carbón	PART_OF
belleza	popular	RANDOM
botón	tamaño	RANDOM
bohordo	pilar	PART_OF
repollo	repollo	PART_OF
ojete	pañería	PART_OF
exclusión	inclusión	ANT
forrado	sin forro	ANT
misericordioso	despiadado	ANT
Leche	futuro	RANDOM
equilibrar	molécula	RANDOM
cuero cabelludo	transferir	HYPER
Fain	con alegría	SYN
morgue	edificio	HYPER
escombros	escombros	SYN
piedra clave	columnata	PART_OF
Helianthus	girasol	SYN
empobrecer	privar	HYPER
creencia	extraño	RANDOM
responder	hostilidad	RANDOM
masculino	cero	RANDOM
imaginación	constelación	RANDOM
encantamiento	deletrear	SYN
filamento	bulbo	PART_OF
folklore	ciencia	HYPER
piscina	reservas	HYPER
frente a	cuello	PART_OF
repoblación forestal	conversión	HYPER
hamburguesa	emparedado	HYPER
paz	gira	RANDOM
cáncer	enlazar	RANDOM
cepillo de dientes	Bigote	HYPER
magnate	magnate	SYN
perversión	actividad	HYPER
iluminado	sin luz	ANT
clemente	inclemente	ANT
endotérmico	exotérmico	ANT
obligado	escritura	HYPER
picar	contratar	RANDOM
dirección	gobierno	SYN
aeródromo	campo	SYN
daño	lesión	SYN
cráneo	cráneo	PART_OF
azufre	impacto	HYPER
compartimiento	magia	RANDOM
preso	paciente interno	SYN
desproporción	proporción	ANT
peticionario	litigador	HYPER
cómoda	habitación	PART_OF
óptico	homo	PART_OF
optimista	pesimista	ANT
burlar	exceder	HYPER
ascender	personal	RANDOM
por suerte	Desafortunadamente	ANT
espectador	testigo	SYN
ochenta	años	PART_OF
lírica	acuñar	RANDOM
inducción	observancia	HYPER
jerarquía	autoridades	PART_OF
corona	periantio	PART_OF
aburrimiento	mal	RANDOM
subcultura	civilización	PART_OF
aritmética	constelación	RANDOM
Error	estrella	RANDOM
clasificado	no clasificados	ANT
FALSO	CIERTO	ANT
glabela	cráneo	PART_OF
torpeza	torpe	SYN
soplar	ganar	RANDOM
lesión	desgracia	HYPER
Tres	troica	SYN
noche	gato	RANDOM
góndola	dirigible	PART_OF
armadura	trolebús	PART_OF
demacrado	pasado	SYN
punto muerto	parada	SYN
trozo de cuero	kilogramo	PART_OF
estridencia	timbre	HYPER
decibel	unidad	HYPER
no técnico	técnico	ANT
disputa común	pelea	SYN
Nota	lluvia	RANDOM
por todo lo alto	solapado	ANT
debilidad	fragilidad	SYN
gruñir	vocalización	HYPER
cosmonauta	astronauta	SYN
permanentemente	temporalmente	ANT
unirse	zapato	RANDOM
corola	flor	PART_OF
rata almizclera	roedor	HYPER
desafiante	intrigante	SYN
limpiar	asco	RANDOM
cuartos traseros	cuadrúpedo	PART_OF
rezagado	perezoso	HYPER
zodíaco	diagrama	HYPER
kb	gigabit	PART_OF
arruinado	nonstarter	HYPER
circulación	diseminación	HYPER
ilógico	lógico	ANT
lírica	habitación	RANDOM
misántropo	gruñón	HYPER
confiable	indigno de confianza	ANT
digitados	sin dedos	ANT
sonorización	registro	HYPER
exigente	especial	SYN
pilus	mamífero	PART_OF
rata	acolchado	HYPER
pes	homo	PART_OF
consagrar	declarar	HYPER
dibujante	artista	HYPER
descontaminación	eliminación	HYPER
compatriota	tema	HYPER
limpiar	ideología	RANDOM
llamar	interactuar	HYPER
aparente	evidente	SYN
centeno	centeno	PART_OF
Misisipí	sonar	RANDOM
masoquista	sádico	ANT
techo	satisfacer	RANDOM
recámara	barril	PART_OF
acreedor	deudor	ANT
cuarenta y seis	XLVI	SYN
emparedado	comida	PART_OF
rama	tela	RANDOM
ácaro	mota	SYN
sentido	pensamiento	HYPER
resultante	variable	HYPER
demasiado	también	SYN
pinchazo	meter	SYN
exaltación	esfera	PART_OF
sección	cirugía	PART_OF
consistencia	inconsecuencia	ANT
concordante	consonante	SYN
emular	imitar	HYPER
orbita	grado	HYPER
vestíbulo	limpiar	RANDOM
educado	educado	SYN
bazar	justa	SYN
modelo	biddy	HYPER
Maxwell	weber	PART_OF
Chou	vegetal	HYPER
trapo	molestar	SYN
techo solar	auto	PART_OF
cuidado	Aparecer	RANDOM
luchar	considerar	HYPER
endosar	autorizar	HYPER
muelle	puerto marítimo	PART_OF
depresivo	estimulante	ANT
camarón	camarón	PART_OF
quintal	kilotones	PART_OF
cuerpo	historia	RANDOM
estilo	flor	PART_OF
poco dispuesto	reacio	SYN
ascender	Oeste	RANDOM
corvejón	ungulado	PART_OF
flota	velocidad	HYPER
gradual	repentino	ANT
gárgaras	sucediendo	HYPER
privados de sus derechos	con derecho a voto	ANT
atún	atún	PART_OF
Waterside	banco	HYPER
recombinar	modificar	HYPER
emocional	sin emociones	ANT
clarividente	precognitiva	SYN
techado	sin techo	ANT
hospitalario	inhóspito	ANT
Oceano	enjuiciamiento	RANDOM
atento	inatento	ANT
acampar	montaje	HYPER
poco	oír	RANDOM
jutzpá	descaro	HYPER
personificar	imputar	HYPER
recuperar	retener	SYN
cambio	gusto	RANDOM
medio	alrededores	HYPER
casa	Luna	RANDOM
atracción	repulsión	ANT
pasar	hierba	RANDOM
núcleo	Novia	RANDOM
China	cable	RANDOM
burlarse de	descuento	HYPER
tirón	actuación	HYPER
retirar	cesar	HYPER
torbellino	corriente	HYPER
biblioteca	planeta	RANDOM
honestidad	fin	RANDOM
transmidor	fábrica	PART_OF
general	específico	ANT
contracción	expansión	ANT
candelabro	poseedor	HYPER
medio	dedo del pie	RANDOM
ratón	tira	RANDOM
heces	excreción	HYPER
cosecha	agregación	HYPER
yema de huevo	huevos	PART_OF
parte	mar	RANDOM
animal	generoso	RANDOM
tipi	presentar	HYPER
oleada	marea	SYN
escalera	edificio	PART_OF
virtuoso	malvado	ANT
salvaguardia	escolta	HYPER
resumen	repetir	HYPER
Mickle	balsa	SYN
cuenta	justicia	RANDOM
vulcanología	geofísica	HYPER
acreedor	deudor	ANT
pañal	prenda	HYPER
examen	pruebas	SYN
pelea de perros	compromiso	HYPER
herpetólogo	zoólogo	HYPER
apogeo	perigeo	ANT
almuerzo	comunicación	RANDOM
mi	milla	SYN
hilo	recitar	HYPER
indexación	agrupamiento	HYPER
estragón	estragón	PART_OF
tipo	chupar	RANDOM
cachiporra	porra	HYPER
casa	desconocido	RANDOM
asesinato	prueba	RANDOM
presidente	presidenta	SYN
nudoso	retorcido	SYN
mandíbula	homo	PART_OF
perezoso	traer	RANDOM
humano	inhumano	ANT
disputa	desacuerdo	HYPER
descubridor	gunsight	PART_OF
piedra angular	edificio	PART_OF
carne de vaca	ilustración	RANDOM
cruz de caballo	buey	PART_OF
Pepino	Pepino	PART_OF
veto	elección	HYPER
código postal	destino	PART_OF
henil	cortar	SYN
simpático	no simpático	ANT
brida	confinar	HYPER
amortiguar	capa	HYPER
endémico	epidemia	ANT
compañero	ver	RANDOM
indemnidad	restitución	SYN
endometrio	matriz	PART_OF
minúsculas	mayúscula	ANT
profesional	no profesional	ANT
conferir	pronunciar	HYPER
ruido sordo	golpear	SYN
nevé	glaciar	PART_OF
carta	disgusto	RANDOM
acción	dobladillo	RANDOM
felizmente	infelizmente	ANT
oportunidad	inadecuación	ANT
pensando	pensamiento	SYN
embalse	internación	SYN
grupo	ocurrencia	HYPER
génesis	sucediendo	HYPER
número de lectores	audiencia	HYPER
radio	carro	PART_OF
concentración	dilución	ANT
afligido	privado	SYN
tender	ayudar	HYPER
mancha	astuto	SYN
chicha	shisha	SYN
cadena	resbalón	RANDOM
completo	concienzudo	SYN
ahondar	cavar	SYN
vida	mesa	RANDOM
a menudo	a menudo	SYN
ladera de la montaña	montar	PART_OF
florecer	vestíbulo	RANDOM
negro	paisaje	RANDOM
enloquecer	trapo	HYPER
intimidar	despertar	HYPER
maleo	tímpano	PART_OF
cuestionable	incuestionable	ANT
creencia	interesar	RANDOM
congenialidad	amabilidad	HYPER
florecer	comercio	RANDOM
fortín	gorro de cocinero	SYN
eje	puntero	PART_OF
aspiración	respiración	PART_OF
hacer	Terminar	HYPER
grad	grado	SYN
semirremolque	aparejo	PART_OF
seducir	pedir	HYPER
mitología	agregación	HYPER
poder	morada	PART_OF
sexagésimo cuarto	fracción	HYPER
imagen	espada	RANDOM
estacional	todo el año	ANT
durian	durian	PART_OF
transportador	molino	PART_OF
admirar	libro	RANDOM
arruga	pliegue	HYPER
torero	torero	SYN
bribón	alguien	HYPER
afluencia	salida	ANT
inclinación	elevación	PART_OF
justar	torneo	PART_OF
quilate	gm	PART_OF
actor	dobladillo	RANDOM
pene	cuerno	RANDOM
cuchara	dragar	PART_OF
esternón	torso	PART_OF
maniobra	maniobra	SYN
discernible	indiscernible	ANT
ortopedía	ortopedía	SYN
micrón	cm	PART_OF
muerto	vivo	ANT
artillería	batería	PART_OF
enfoque	lente	RANDOM
cuña	edificio	PART_OF
arteriosclerosis	patología	HYPER
presión	actuación	HYPER
aire	gorra	RANDOM
Classe baja	clase media	ANT
desvelo	vigilancia	SYN
hueso	sombra	RANDOM
preceder	ir	HYPER
generosidad	tacañería	ANT
incómodo	inepto	SYN
no residencial	residencial	ANT
multicolor	multicolor	SYN
organización	autoridades	PART_OF
anfitriona	posadero	HYPER
pintar	parte	RANDOM
mm	centímetro	PART_OF
acortar	recortar	HYPER
desecación	plastinación	PART_OF
lucha	ir	HYPER
tempestuoso	salvaje	SYN
caja	ocupado	RANDOM
masoquista	sádico	ANT
definido	indefinido	ANT
vaticinador	fuego antiaéreo	PART_OF
adornar	embellecer	HYPER
Mejorana	orégano	PART_OF
afecto	ideología	RANDOM
menos	más	ANT
crucificar	diablo	HYPER
menor	perro de calle	SYN
lápida sepulcral	tumba	PART_OF
elegante	alegre	SYN
desinflar	recortar	HYPER
suéter tipo con cuello de tortuga	saltador	HYPER
pesadez	ligereza	ANT
carrete	girar	SYN
fascinante	fascinante	SYN
censura	criticar	HYPER
mayoria	edad adulta	PART_OF
adúltero	extramatrimonial	SYN
cojinete	heráldica	HYPER
deriva	título	SYN
pregonero	perro	SYN
compensado	estipendiario	SYN
ampliar	afectar	HYPER
atrocidad	barbarie	SYN
vela	barrer	SYN
perder	documento	RANDOM
mañana	lo sucesivo	HYPER
destructible	indestructible	ANT
saurópodo	dinosaurio	HYPER
menudillos	ave	PART_OF
bonito	rango	RANDOM
injusto	injusto	SYN
macizo	distancia	PART_OF
movimiento	padre	RANDOM
estante	aparador	PART_OF
tortilla	envolver	PART_OF
deberes	enseñando	PART_OF
anestésico	anestésico	SYN
pie	pasto	PART_OF
deshonestamente	honestamente	ANT
todopoderoso	omnipotente	SYN
pectoral	tórax	PART_OF
caña	raqueta	PART_OF
válvula	bomba	PART_OF
minuto	Gol	RANDOM
circunstancia	ajuste	SYN
tarjeta	cartulina	HYPER
destino	correspondencia	PART_OF
ánodo	cátodo	ANT
educacionista	educacionista	SYN
rodera	imprimir	HYPER
infraestructura	estructura	PART_OF
intención	significado	HYPER
rotor	más suave	PART_OF
Él w	molde	HYPER
bramido	grito	HYPER
derrotado	invicta	ANT
melamina	álcali	HYPER
colisión	desacuerdo	HYPER
diplomático	sin tacto	ANT
apuntador	seguidor	HYPER
ranúnculo	hierba	HYPER
bushel	quintal	PART_OF
bota	chimenea	RANDOM
ladera	colina	PART_OF
legal	lícito	SYN
lista	inclinación	HYPER
estafa	Pro	ANT
cps	kc	PART_OF
tímpano	caput	PART_OF
elevación	altura	SYN
firma	manera	HYPER
miseria	paso	RANDOM
pasar	desconocido	RANDOM
estribo	tímpano	PART_OF
funcional	utilizable	SYN
escombros	basura	SYN
pecho	vertebrado	PART_OF
gobierno	marinero	PART_OF
caja del cráneo	hueso	HYPER
inmersión	inclinación	SYN
cúspide	bomba	PART_OF
anti	Pro	ANT
entregar	renuncia	HYPER
andar de forma vacilante	tropezón	SYN
Jack	bochas	PART_OF
masculino	mucho	RANDOM
tweed	blanco	SYN
enlazar	televisión	RANDOM
esperanza	deseo	HYPER
mando	pasar por alto	SYN
mujer participante	él que hace leyes	HYPER
multitudinario	incontable	SYN
anterior	posterior	ANT
inorgánico	orgánico	ANT
Sonic	subsónico	ANT
Australia	esposa	RANDOM
bodega	lavar	RANDOM
placenta	florecer	PART_OF
inconformista	recusante	SYN
chorro	curso	HYPER
pica	pie	PART_OF
administración	régimen	PART_OF
defensa	ofensa	ANT
Grosz	zloty	PART_OF
paseo	tropa	SYN
escálamo	gallo	PART_OF
Classe baja	clase alta	ANT
salto	pensar	RANDOM
ciruela	ciruela	PART_OF
uña	manus	PART_OF
hermano	relación	HYPER
nacional	exterior	ANT
carne	escenario	RANDOM
cóclea	laberinto	PART_OF
veinte	madurez	PART_OF
eflorescencia	inflorescencia	SYN
descifrar	desencriptar	SYN
insignificancia	significado	ANT
decremento	incremento	ANT
carne	cortar con tijeras	RANDOM
amígdala	palio	PART_OF
balancín	artefacto	HYPER
antebrazo	homo	PART_OF
pallidum	estriado	PART_OF
muelle	edificio	PART_OF
espectro	aeronave	HYPER
mandioca	Gari	PART_OF
sin costura	sin forro	SYN
hueso	atravesar	RANDOM
ceja	caput	PART_OF
dendrita	neurona	PART_OF
hockey	fijar	RANDOM
necesario	necesario	SYN
religioso	secular	ANT
pretensión	disimulo	HYPER
detención	consiguiendo	HYPER
Mañana	broncearse	RANDOM
institucionalizado	institucionalizado	SYN
fiesta	chaqueta	RANDOM
flota	aerovía	PART_OF
por suerte	infelizmente	ANT
pregonero	promotor	HYPER
pacto	declarar	HYPER
cuello	herramienta	RANDOM
diafragma	preventivo	HYPER
cut-up	falsificador	SYN
trazable	ilocalizable	ANT
asociación	disociación	ANT
reorganizar	mando	HYPER
especialidad	peculiaridad	SYN
inocuo	nocivo	ANT
Noticias	piel	RANDOM
claridad	opacidad	ANT
naufragio	prevenir	HYPER
tirón	remolcar	HYPER
corchete	brazalete	PART_OF
estilo	pistilo	PART_OF
diezmo	transferir	HYPER
línea	risa	RANDOM
medio	cola	RANDOM
cumpleaños	tienda	RANDOM
ruidoso	tristeza	RANDOM
corredor	intermediario	SYN
nudo	tablón	PART_OF
extirpar	rasguño	SYN
inodoro	oloroso	ANT
hervir	separación	RANDOM
los suburbios	afueras	PART_OF
elote	maíz	PART_OF
deseo	pronunciar	HYPER
parabrisas	avión	PART_OF
electrodo	tubo	PART_OF
bonito	ciencia	RANDOM
payaso	broma	HYPER
presurizar	sobrealimentar	SYN
belleza	cepillo	RANDOM
delincuente	malhechor	SYN
pecho	alcanzar	HYPER
ministro	duro	RANDOM
atractivo	escritura	HYPER
nombre	detallar	HYPER
diccionario geográfico	atlas	PART_OF
invadir	Progreso	HYPER
multitudinario	miríada	SYN
factor	prestar	HYPER
celebracion	jubilación	SYN
vestíbulo	humano	RANDOM
orquesta	teatro	PART_OF
batalla	correo	RANDOM
pedal	enjuiciamiento	RANDOM
abundante	escaso	ANT
engañar	carta	RANDOM
espesor	delgadez	ANT
mítica	mítico	SYN
benigno	maligno	ANT
dama	herramienta	RANDOM
padre	Perfecto	RANDOM
mantecoso	restaurante	HYPER
Misisipí	salvar	RANDOM
adulto	sello	RANDOM
mandioca	mandioca	PART_OF
diáfano	transparente	SYN
joya	joyería	PART_OF
goading	elogio	HYPER
situación	asegurar	HYPER
pomelo	agrios	HYPER
almuerzo	Tiffin	SYN
murciélagos	loco	SYN
cada día	cotidiano	SYN
asegurador	asegurador	SYN
encadenar	candado	PART_OF
frugalidad	discreción	HYPER
centelleo	vigor	HYPER
idioma	reto	RANDOM
implosión	explosiva	PART_OF
caja	edificio	PART_OF
alquilado	unchartered	ANT
bronceado	bronceado	SYN
otoñal	veraniego	ANT
ochenta	años	PART_OF
microsegundo	milisegundo	PART_OF
ligne	pie	PART_OF
caso	mamífero	RANDOM
corretaje	preocupación	RANDOM
quemar	viento	RANDOM
paz	sostener	RANDOM
pírrico	medida	HYPER
playa	contento	RANDOM
finalizando	recital	PART_OF
pequeño	naturaleza	RANDOM
brócoli	brócoli	PART_OF
cinturón	techo	RANDOM
hacerse querer por	satisfacer	HYPER
contrario	relación	HYPER
aritmética	arma	RANDOM
deducible	no deducible	ANT
cruce	hibridación	SYN
desnutridos	nutridos	ANT
pubertad	adolescencia	PART_OF
continuación	discontinuación	ANT
pagado	no pagado	ANT
engatusar	palabrería	SYN
alelo	factor	HYPER
sótano	Menos	RANDOM
Cállate	lavar	HYPER
uretra	falo	PART_OF
núcleo	Placer	RANDOM
fama	infamia	ANT
terrenal	celestial	ANT
responsabilidad	fibra	PART_OF
almacenamiento	plataforma	PART_OF
metacarpiano	guante	PART_OF
anfípodo	crustáceo	HYPER
brecha	ubicación	HYPER
mezcolanza	mezcla	SYN
externo	interno	ANT
sobrino	sobrina	ANT
un montón	montón	SYN
hockey	enfermedad	RANDOM
menos	más	ANT
estragón	estragón	PART_OF
presa	kilómetro	PART_OF
fidelidad	fidelidad	SYN
descolorarse	rebanar	SYN
película	cuidado	RANDOM
tedioso	aburrido	SYN
suspensión	automotor	PART_OF
cenefa	textil	PART_OF
alto	puntada	RANDOM
bofetada	despreocupado	SYN
profundidad	superficialidad	ANT
bañera	cueva	RANDOM
membrillo	membrillo	PART_OF
mal uso	usado	ANT
clavija	bote	PART_OF
dominó	mascarada	PART_OF
nudo corredizo	Riata	PART_OF
raja	patricio	HYPER
susceptibilidad	condición	HYPER
salida	ingreso	ANT
chelín	péndulo	PART_OF
imprevisibilidad	incertidumbre	HYPER
impala	antílope	HYPER
mejor	peor	ANT
autor de la pregunta	hablador	HYPER
Seguir	producción	HYPER
pulgada	pie	PART_OF
movimiento	criminal	RANDOM
artificialmente	naturalmente	ANT
neciamente	sabiamente	ANT
mutagénesis	mutación	PART_OF
penetración	entrar	HYPER
rayo	aleta	PART_OF
diluido	sin diluir	ANT
sin límites	sin límites	SYN
transmidor	molino	PART_OF
zurdo	diestro	ANT
libra	quintal	PART_OF
Aurora	amanecer	SYN
sangre	igual	RANDOM
vencimiento	ventilación	PART_OF
rata	peinado	PART_OF
bañera	superficie	RANDOM
firmeza	inestabilidad	ANT
volumen	blandura	ANT
Dulce de azúcar	manipular	SYN
ciudad natal	pueblo	HYPER
nivel	incorrecto	RANDOM
tapa	recoger	RANDOM
acerico	relleno	HYPER
idioma	mujer	RANDOM
20	veinte	SYN
distopía	utopía	ANT
lámina	hueso	PART_OF
calamar	calamar	PART_OF
grito	pronunciar	HYPER
oriental	occidental	ANT
desproporcionadamente	proporcionalmente	ANT
casa	trama	RANDOM
consciente	inconsciente	ANT
disímil	similar	ANT
espermatogénesis	creciente	HYPER
jinete	jinete	HYPER
venación	follaje	PART_OF
cama	desarrollar	RANDOM
pista	pista	SYN
parroquia	episcopado	PART_OF
alta tecnología	baja tecnología	ANT
heredado	transmitida	SYN
periódico	revenant	SYN
Interprete	traductor	SYN
analfabetismo	alfabetismo	ANT
cosmopolita	provincial	ANT
pez globo	pez globo	PART_OF
historia	Delgado	RANDOM
segmentación	el embarazo	PART_OF
desequilibrio	equilibrio	ANT
decisión	determinación	SYN
apoyarse	propina	SYN
idoneidad	inadecuación	ANT
sin objetivo	flotante	SYN
media	sur	RANDOM
transmidor	fabricación	PART_OF
dg	gm	PART_OF
excepto	expulsión	HYPER
corchete	bolso	PART_OF
ternera	becerro	PART_OF
periantio	angiosperma	PART_OF
implantación	localización	HYPER
ganso	punzada	HYPER
aburrimiento	misterio	RANDOM
cárcel	salud	RANDOM
frambuesa	razz	SYN
bajo	vestir	RANDOM
baloncesto	elemento	RANDOM
singularidad	unicidad	SYN
perdonar	conceder	HYPER
nudo	residencia	RANDOM
con optimismo	con pesimismo	ANT
organizar	sindicar	SYN
hadj	Hajj	SYN
impresionar	impresión	SYN
votar	votación	SYN
brillo	luminosidad	SYN
barato	llamativo	SYN
rima	escarcha	SYN
baya	baya	PART_OF
aire	correr	RANDOM
torcido	flojo	SYN
gramático	ungrammatical	ANT
sin ventilación	ventilado	ANT
frialdad	picor	ANT
capitalismo	socialismo	ANT
aerógrafo	rociar	HYPER
sensiblero	sentimentaloide	SYN
extremadamente	astutamente	SYN
bípedo	cuadrúpedo	ANT
intensificando	moderador	ANT
presbiterio	Iglesia	PART_OF
superar	ir	HYPER
fianza	sistema	HYPER
gigante	coloso	SYN
cerviz	útero	PART_OF
sin sentido del humor	humorístico	ANT
evocación	despojo	PART_OF
pinger	asdic	PART_OF
movimiento	Placer	RANDOM
hacia abajo	hacia arriba	ANT
mientras tanto	intervalo	HYPER
armario	experimentar	RANDOM
cúbico	lineal	ANT
dedicar	determinar	HYPER
sueco	nabo sueco	PART_OF
pájaro	robar	RANDOM
barco	Organo	RANDOM
sin hojas	frondoso	ANT
alucinación	pensamiento	HYPER
proyección	predicción	HYPER
principal	primario	SYN
negro	ennegrecido	SYN
oferta	tippy	SYN
caso	alguien	HYPER
escuela	edificio	HYPER
miscelánea	smorgasbord	SYN
unión	consolidación	HYPER
maravilloso	muy	SYN
destello	santiamén	SYN
pasar	curva	RANDOM
muelle	enérgico	SYN
matrimonio	estrecho	RANDOM
centavo	Boliviano	PART_OF
gimel	grafema	HYPER
catástrofe	desastre	SYN
ojete	cortina	PART_OF
salir	organismo	RANDOM
dominar	eclipse	SYN
cuenta	melocotón	RANDOM
pasado	complejo	RANDOM
parasailing	volador	HYPER
peristome	invertebrado	PART_OF
escanear	buscar	HYPER
pulpo	pulpo	PART_OF
rosado	rap	SYN
añadir	héroe	RANDOM
fabricar	tranquilo	RANDOM
pasillo	expandir	RANDOM
joyería	joyería	SYN
pedal	único	RANDOM
bloquear	interrumpir	HYPER
viva	muerto	ANT
virginidad	vagina	PART_OF
obstáculo	interferencia	SYN
America	duro	RANDOM
frente	campo de batalla	PART_OF
insignificante	significativo	ANT
bendito	maldito	ANT
labor	maternidad	PART_OF
fase	ciclo	PART_OF
muchísimo	montones	SYN
atractor	alguien	HYPER
ampliar	ensanchar	SYN
hurgando	empuje	SYN
juego de pelota con bate	juego de pelota	HYPER
enfoque	interesar	RANDOM
viuda	siendo	HYPER
labor	aguja	RANDOM
cuarto de galón	galón	PART_OF
arrendamiento	tarro	RANDOM
goma	rumia	SYN
mentira	jubilarse	RANDOM
chocolate	escenario	RANDOM
camarilla	interactuar	HYPER
nudo	tira	RANDOM
reliquia de familia	pertenencias	HYPER
baloncesto	justicia	RANDOM
cuerno	sello	RANDOM
lápida mortuoria	acueducto	PART_OF
mochilero	caminante	HYPER
Gumbo	okra	PART_OF
anclaje	puerto	PART_OF
salto	único	RANDOM
lleno de gente	con poca gente	ANT
análisis	síntesis	ANT
penosamente	sin dolor	ANT
montaje	desmontaje	ANT
formalidad	informalidad	ANT
Japón	hierba	RANDOM
billar	movimiento	HYPER
planetario	planetario	PART_OF
desembarco	embarque	ANT
importar	marcha atrás	RANDOM
reino	dominio	HYPER
nación	subir	RANDOM
Bannister	balcón	PART_OF
gunstock	pistola	PART_OF
reverencia	reverencia	HYPER
cacareo	charla	SYN
foque	resistir	SYN
segundo	hora	PART_OF
superioridad	dominación	HYPER
responsabilidad	fibra	PART_OF
minúscula	grafema	HYPER
dolor	satisfacción	RANDOM
organizado	sindicalizada	SYN
devolución	evolución	ANT
nauseabundo	nauseabundo	SYN
mallado	red	SYN
tirón	pronunciar	HYPER
inmaduro	inmaduro	SYN
analfabeto	alfabetizado	ANT
salinidad	salinidad	SYN
pleno verano	verano	PART_OF
pálido	almohada	RANDOM
depositar	poner	HYPER
interesante	poco interesante	ANT
picar	líquido	RANDOM
próximo	saliente	SYN
mordazmente	penetrante	SYN
chile	chile	SYN
episcopado	territorio	HYPER
corriendo	en pie	ANT
personalidad	alguien	PART_OF
exponente	proponente	SYN
exasperante	enloquecedor	SYN
soja	soja	PART_OF
empujoncito	descanso	RANDOM
soplo	de fumar	PART_OF
fibra	alguien	PART_OF
delantal	campo	PART_OF
compuerta	compuerta	PART_OF
molusco	mariscos	SYN
lanzamiento	transmitir	HYPER
adagio	diciendo	HYPER
salón	domicilio	PART_OF
humildad	teclado	RANDOM
noventa	años	PART_OF
precisamente	inexactamente	ANT
descendencia	golpear	RANDOM
nuca	cerviz	PART_OF
adaptador	transcriptor	SYN
equilibrar	maceta	RANDOM
folleto	bomba	PART_OF
humano	orden	RANDOM
interiormente	externamente	ANT
ordinario	forma	RANDOM
rompecabezas	especular	HYPER
sin agallas	valiente	ANT
pecho	ver	RANDOM
pájaro	estrés	RANDOM
charla	conversacion	HYPER
avergonzado	sin vergüenza	ANT
imperfección	perfección	ANT
bozal	fauna	PART_OF
doblez	incorporar	HYPER
presidio	comisión	HYPER
pedal	ciclo	PART_OF
Miro	conífera	HYPER
ir	armonizar	HYPER
gracia	comportamiento	HYPER
superficie plana	peinado	HYPER
generalista	especialista	ANT
abertura	telescopio	PART_OF
punta de lanza	lanza	PART_OF
elegibilidad	inelegibilidad	ANT
hoja	mantener	RANDOM
okra	Gumbo	PART_OF
matriz	dígito	PART_OF
acortar	cultivar	RANDOM
infraestructura	sistema	PART_OF
modelador	alguien	HYPER
interior	exterior	ANT
explotado	sin explotar	ANT
Correa	equipaje	PART_OF
árbol desmochado	acortar	HYPER
convergencia	divergencia	ANT
arco	motos acuáticas	PART_OF
pañuelo	textil	HYPER
picotear	trimestre	PART_OF
somnolencia	desvelo	ANT
inmigrante	migratorio	SYN
bocado	servicio	PART_OF
fritura	saltear	SYN
alcahuete	malhechor	HYPER
rápido	desistir	HYPER
pollo	broncearse	RANDOM
patrullero	defensor	HYPER
la dirección del viento	contra el viento	ANT
brillante	suave	RANDOM
ginseng	ginseng	PART_OF
juez	enjuiciamiento	RANDOM
insolvencia	solvencia	ANT
admitido	no reconocida	ANT
pene	asqueroso	RANDOM
ráfaga	ajuste	SYN
oxígeno	casa	RANDOM
Misisipí	lento	RANDOM
alborada	luz	PART_OF
El Rengo	detener	SYN
paciente interno	paciente externo	ANT
diezmar	eliminar	SYN
capacidad	incapacidad	ANT
infranqueable	pasable	ANT
sobrino	sobrina	ANT
cebo	reunión	SYN
Chile	jalapeño	PART_OF
inflamado	despertado	SYN
Misisipí	ven	RANDOM
limpiar	Por favor	RANDOM
Morello	Morello	PART_OF
bañera	cadena	RANDOM
ratón	amabilidad	RANDOM
chip	infelicidad	RANDOM
explosión	desplazar	HYPER
dolor	literatura	RANDOM
patada	kvetch	SYN
veleta	plumaje	PART_OF
realizable	manejable	SYN
desorientador	orientadora	ANT
enfado	carta	RANDOM
carne de vaca	misterio	RANDOM
caída	reducir	HYPER
bueno	indecente	ANT
papada	caput	PART_OF
arrestar	pellizco	SYN
maleable	de tensión	SYN
daños y perjuicios	compensación	SYN
sosegado	inquieto	ANT
defensa	ofensa	ANT
ecuatorial	polar	ANT
silbido	rosado	SYN
en	em	PART_OF
petardas	sensiblero	SYN
prorrateo	parcelación	SYN
ocioso	fabricar	RANDOM
consola	piano	PART_OF
ascendente	condición	HYPER
diversidad	variedad	SYN
caramelo	cable	RANDOM
colusivo	connivencia	SYN
escéptico	intelectual	HYPER
caramelo	vaso	RANDOM
significación	mensaje	HYPER
almuerzo	rojo	RANDOM
atmósfera	llenar	RANDOM
ratón	paraguas	RANDOM
bancarrota	proceder	HYPER
becerro	hoja	RANDOM
valiente	autopista	RANDOM
comedia	tragedia	ANT
chocolate	neutrón	RANDOM
emoción	excitar	HYPER
pretil	balcón	PART_OF
postquemador	turboventilador	PART_OF
quemar	lente	RANDOM
rotor	encendido	PART_OF
cuartos traseros	torso	PART_OF
gruñido	gruñir	SYN
pastor	reverendo	HYPER
malla	arrebatar	HYPER
sanitario	antihigiénico	ANT
estambre	florecer	PART_OF
aterrizado	sin tierras	ANT
cinturón	pronunciar	HYPER
caramelo	palabra	RANDOM
parentesco	conexión	HYPER
desfallecer	vacilante	SYN
deformado	deforme	SYN
colindar	frontera	SYN
sustrato	componente	HYPER
miniatura	pulgar	PART_OF
calificar	cumplir	HYPER
insubordinado	subordinar	ANT
exposición	agrupamiento	HYPER
desfavorecer	identificar	HYPER
colina	ventana	RANDOM
arco	vestido	RANDOM
animal	Servicio	RANDOM
manga	prenda	PART_OF
falso	ingenuo	ANT
pájaro carpintero	eje	SYN
timón	lancha fuera borda	PART_OF
cinturón	Hobby	RANDOM
aprender	almohada	RANDOM
comunalidad	individualidad	ANT
aclarar	modificar	HYPER
derrotado	discomfited	SYN
billete de banco	tras verde	SYN
quemar	nieve	RANDOM
pelota	estudiante	RANDOM
Error	guay	RANDOM
besos	juegos previos	HYPER
aumento	disminución	ANT
dócil	obstinado	ANT
pastoso	gachas	SYN
antagonista	sinérgica	ANT
compuerta	restricción	HYPER
pantalones deportivos	sudadera	PART_OF
capa	laminado	PART_OF
canabis	ganar	RANDOM
cabina	astronave	PART_OF
teclado	pensar	RANDOM
primero	auto	PART_OF
claridad	oscuridad	ANT
ridículo	burlarse de	HYPER
sobresaliente	Cubierta	SYN
cortés	descortés	ANT
besador	homo	PART_OF
mercado	escala	RANDOM
disforia	euforia	ANT
anfibio	terrestre	ANT
disminución	mejora	ANT
milenio	ismo	HYPER
espada	reloj	RANDOM
4	dígito	HYPER
publicación	producto	HYPER
río abajo	río arriba	ANT
comprobar	retardar	SYN
sin carácter	espinosa	ANT
cambiable	mudable	SYN
oblicuo	paralela	ANT
nivel	estatua	RANDOM
arado	transmutar	HYPER
dispersar	informar	HYPER
negar	renegar de	HYPER
sesenta	años	PART_OF
miserable	insignificante	SYN
hipermetropía	presbicia	SYN
cajón	buffet	PART_OF
nacimiento	ellos	RANDOM
esfenoides	cráneo	PART_OF
corchete	bolso	PART_OF
rodador	artesano	HYPER
retazo	cortar con tijeras	SYN
abrigo	poner	HYPER
inferior	Desierto	RANDOM
labor	el embarazo	PART_OF
adelante	adelante	SYN
Cuarto	ocioso	RANDOM
chip	mancha	SYN
antiguo	bueno	RANDOM
blanquear	recular	SYN
cazar	desviar	HYPER
caput	fauna	PART_OF
centavo	quetzal	PART_OF
audacia	timidez	ANT
desorganización	disturbio	HYPER
compartimiento	valioso	RANDOM
Chomp	alimentación	HYPER
Marfil	colmillo	SYN
rótula	rodilla	PART_OF
crucificar	grava	HYPER
deshonra	vergüenza	SYN
lío	tumulto	SYN
piedra clave	arco	PART_OF
herir	cero	RANDOM
lo aburrido	nitidez	ANT
acelerar	prisa	SYN
satsuma	satsuma	PART_OF
externamente	internamente	ANT
naturista	alguien	HYPER
expansivo	grandioso	SYN
Organo	nube	RANDOM
bolígrafo	cuadrado	RANDOM
pasar	confundir	RANDOM
cc	mil	SYN
Buss	Beso	SYN
me gusta	casa	RANDOM
elegibilidad	inelegibilidad	ANT
improbabilidad	probabilidad	ANT
baloncesto	acuñar	RANDOM
pronóstico	diagnóstico	HYPER
nuez moscada	nuez moscada	PART_OF
aplastar	oprimir	SYN
miembro	arco	PART_OF
nuevo	papel	RANDOM
incorporado	integrado	SYN
siguiendo	líder	ANT
amistoso	teatro	PART_OF
medicina	suave	RANDOM
compasión	misericordia	HYPER
armonizar	ajuste	HYPER
Salir	resultado	SYN
cáliz	espira	HYPER
deflacionista	inflacionista	ANT
peligro	peligro	SYN
aflojamiento	apriete	ANT
tímido	asustar	HYPER
matrimonio	tienda	RANDOM
mareo	síntoma	HYPER
indeciso	irresoluto	SYN
castaña	castaña	PART_OF
amortiguar	suspensión	PART_OF
pista	ferrocarril	PART_OF
endeudamiento	responsabilidad	SYN
playa	prueba	RANDOM
aprender	RAM	RANDOM
Leche	fuerte	RANDOM
barba	cabra	PART_OF
faringe	cerviz	PART_OF
facultativo	obligar	ANT
llevar	saber	RANDOM
cápsula	dosis	HYPER
beatífico	santo	SYN
hierro	bonito	RANDOM
embargo	rechazar	HYPER
flota	aerolínea	PART_OF
importar	baile	RANDOM
finagle	agenciarse	SYN
colectivo	distributivo	ANT
central	periférico	ANT
obturador	cámara	PART_OF
alto	teléfono	RANDOM
Correa	osito de peluche	PART_OF
fregado	limpieza	HYPER
diplomático	poco diplomático	ANT
compresible	incompresible	ANT
bondad	atributo	HYPER
glotón	carnívoro	HYPER
sanción	empoderamiento	HYPER
capilar	termómetro	PART_OF
mil	decilitro	PART_OF
tensión	utilizar	HYPER
en popa	delantero	ANT
Mañana	lado	RANDOM
costilla	motos acuáticas	PART_OF
extrovertido	introvertido	ANT
escalada	estudiante	RANDOM
benevolencia	malevolencia	ANT
facial	homo	PART_OF
cortar	granero	PART_OF
centímetro	metro	PART_OF
Wainwright	oficial	HYPER
engañar	aparejo	SYN
humildad	imagen	RANDOM
muelle	lapso	PART_OF
convento	secta	PART_OF
canal	alcantarilla	SYN
barraca	remover	HYPER
diapasón	acordeón	PART_OF
consumado	no consumado	ANT
ascomiceto	siendo	HYPER
lápida sepulcral	tumba	PART_OF
educador	pedagogo	SYN
asdic	sonar	SYN
trenza	distorsionar	HYPER
mamífero	espacio	RANDOM
lúcido	transparente	SYN
interminable	interminable	SYN
éticamente	sin ética	ANT
ardor	vivacidad	SYN
rap	grifo	SYN
cerca	yarda	RANDOM
río abajo	río arriba	ANT
sucesión	pedido	HYPER
muelle	puerto	PART_OF
pesadilla	soñando	HYPER
fumador	fumador	PART_OF
ng	mg	PART_OF
azul	fabricar	RANDOM
locura	cordura	ANT
constructivo	destructivo	ANT
entrega	serie	PART_OF
comienzo	comenzando	SYN
hervir	pandilla	RANDOM
disolución	libertinaje	SYN
frío	jalapeño	PART_OF
engañar	crítica	SYN
enemistarse	trapo	HYPER
descubridor	alcance	PART_OF
confinamiento	maternidad	PART_OF
mejorar	empeoramiento	ANT
cuello	enorme	RANDOM
rechazo	rechazar	HYPER
patinar	patinar	HYPER
igual	similar	SYN
feroz	salvaje	SYN
Día del Juicio Final	sucediendo	HYPER
inhalación	respiración	PART_OF
adentro	al aire libre	ANT
piloto	marinero	HYPER
exclusión	inclusión	ANT
astronómico	astronómico	SYN
dominar	eclipsar	SYN
charla	Schmooze	HYPER
locador	ingeniero	HYPER
bota	gratis	RANDOM
ignorancia	tela	RANDOM
fragante	maloliente	ANT
volverse	embellecer	HYPER
decelerar	retardar	SYN
blanco	descolorar	HYPER
arpón	embrague	HYPER
partes	rodear	HYPER
del este	oeste	ANT
autor	infeliz	RANDOM
enredadera	alguien	HYPER
vibraciones	vibráfono	SYN
tos	síntoma	HYPER
lesionar	tanque	RANDOM
cabezal	lancha fuera borda	PART_OF
collage	acumulación	HYPER
insertar	pronunciar	HYPER
esperanza	obtener	RANDOM
rostro	homo	PART_OF
barco	crecimiento	RANDOM
longitud de onda	actitud	HYPER
pasillo	estándar	RANDOM
prólogo	teatro	PART_OF
privación	destino	HYPER
arena	campo	HYPER
centavo	austral	PART_OF
suciedad	amabilidad	ANT
mantener	homosexual	RANDOM
modernismo	género	HYPER
llave	calcetín	RANDOM
perezoso	sonar	RANDOM
cercanía	franqueza	ANT
inspirador	aburrida	ANT
indigente	necesitado	SYN
caprichoso	caprichoso	SYN
aneurisma	trastornado	HYPER
byte	unidad	HYPER
zag	zig	SYN
coso	zit	SYN
aferente	eferente	ANT
borde del camino	tránsito	PART_OF
veces	operación	HYPER
monismo	pluralismo	ANT
reconstruir	reconstruir	SYN
fumador	pez globo	PART_OF
monoteísmo	politeísmo	ANT
suspender	expulsar	HYPER
quintal	quintal	SYN
excusable	inexcusable	ANT
Lanza libre	persona de libre dedicación	SYN
ajuste	tolerancia	SYN
jaranear	wassail	SYN
cáncer	carrera	RANDOM
inespecífica	específico	ANT
prólogo	teatro	PART_OF
vestíbulo	zona	HYPER
caballa	limpiabotas	PART_OF
cuidado	negocio	RANDOM
centímetro	metro	PART_OF
interestatal	intraestatal	ANT
admirar	Produce	RANDOM
ubre	niñera	PART_OF
actividad	inactividad	ANT
entonado	cantar la canción	SYN
nodo	tallo	PART_OF
reja	enrejado	SYN
desfavorecer	inclinación	HYPER
consola	calmar	SYN
canal	impartir	SYN
varonil	afeminado	ANT
certificar	autorizar	HYPER
buffer	auto	PART_OF
dominante	recesivo	ANT
traficante	vendedor	SYN
indebido	irrazonable	SYN
Nota	viaje	RANDOM
caduco	hojas perennes	ANT
sari	sari	SYN
con aprobación	con desaprobación	ANT
absolución	penitencia	PART_OF
excusado	disimulado	ANT
más lejos	promover	SYN
lona	tienda	HYPER
panal	Colmena	PART_OF
descendencia	linaje	SYN
bloquear	posición	HYPER
bañera	todas	RANDOM
ascensor	tranquilo	RANDOM
mezcla	emoción	RANDOM
créditos	película	PART_OF
Desafortunadamente	infelizmente	SYN
Huffing	exhalación	HYPER
extrínseco	intrínseco	ANT
aerobio	anaeróbica	ANT
acidez	alcalinidad	ANT
abstracto	hormigón	ANT
sacrificio	carnicería	PART_OF
piso de arriba	edificio	PART_OF
dialéctico	letras	HYPER
dracma	lb	PART_OF
comenzando	finalizando	ANT
cuello	mineral	RANDOM
yo	soldado	RANDOM
bicicleta	suave	RANDOM
salmón rojo	salmón	HYPER
chile	pimentón	PART_OF
dirigir mal	profano	SYN
apartamento	antiguo	RANDOM
criado	educación	SYN
casa	tener éxito	RANDOM
centro del campo	cuenco	PART_OF
transeúnte	viajero	HYPER
hipertermia	hipotermia	ANT
Dateline	envío	PART_OF
bota	ver	RANDOM
cazuela	víveres	HYPER
enfermar	daño	HYPER
afeitado	sin afeitar	ANT
pulmón	droga	RANDOM
destello	destello	SYN
matriz	dáctilo	PART_OF
tolva	canal	HYPER
poco práctico	Ventoso	SYN
fiesta	cubrir	RANDOM
cielo	paraíso	SYN
añadir	ordinario	RANDOM
paso	modificación	HYPER
suplantación	sustitución	HYPER
buffet	vivienda	PART_OF
estafa	Pro	ANT
bastante	algo	SYN
divertido	desviados	SYN
bobo	pecado	SYN
pequeño	Desierto	RANDOM
horizonte	perfil	PART_OF
bluff	falsificación	HYPER
engañar	frustrar	SYN
pirámide	pose	HYPER
constitucional	constitutivo	SYN
lengüeta	lanza	PART_OF
locura	sabiduría	ANT
interjección	interpolación	SYN
guerrilla	irregular	SYN
hipertiroidismo	hipotiroidismo	ANT
adoctrinar	instruir	HYPER
clase	construcción	RANDOM
asesinato	tener éxito	RANDOM
salsa	condimento	HYPER
atascado	despegado	ANT
chabola	vocal	HYPER
selva	botánica	HYPER
maltratar	palma	HYPER
paz	angustia	RANDOM
peligro	la seguridad	ANT
llamada	cubiertos	RANDOM
recogido	reunido	SYN
extra	especial	SYN
pecho	vagón	RANDOM
nudo corredizo	Ginebra	PART_OF
llevar	reducir	RANDOM
excursión	excursión	SYN
magníficamente	maravillosamente	SYN
Norther	norte	SYN
atleta	correr	RANDOM
clase	escapar	RANDOM
saltador	arcada	PART_OF
muelle	enérgico	SYN
tecnicismo	trivialidad	SYN
absoluto	relativo	ANT
firmeza	inestabilidad	ANT
legalmente	ilegalmente	ANT
Australia	caminar	RANDOM
compañero	pareja	PART_OF
autodefensa	proteccion	HYPER
expedidor	persona de negocios	HYPER
fondo	sin fondo	ANT
cantera	desgraciado	HYPER
acerca de	cerca	SYN
afecto	alegría	RANDOM
rasguño	abertura	SYN
flagelación	flagelación	SYN
jefe	mejorar	RANDOM
tosquedad	aspereza	HYPER
sección	agrios	PART_OF
certeza	incertidumbre	ANT
frecuentemente	con poca frecuencia	ANT
rebote	aros	PART_OF
rápido	inmediatamente	SYN
cosmopolita	endémico	ANT
augur	pronóstico	SYN
adulto	equipaje	RANDOM
ratonera	maniobra	HYPER
mcg	miligramo	PART_OF
flexible	depresión	SYN
piso	edificio	PART_OF
inmadurez	madurez	ANT
fijador	metadona	SYN
madriguera	ahondar	HYPER
mierda	excreción	HYPER
parachoque	auto	PART_OF
carne de vaca	bueyes	PART_OF
inmoralidad	moralidad	ANT
gravedad	ligereza	ANT
pista	campo	PART_OF
manzana	individual	RANDOM
rótula	rodilla	PART_OF
ascender	sombra	RANDOM
navegar	maniobra	HYPER
escape	reloj	PART_OF
ceder	cambio	SYN
boquilla	respirador	PART_OF
santuario	Iglesia	PART_OF
baboso	feo	SYN
topera	montículo	HYPER
escote	saltador	PART_OF
continuo	discontinuo	ANT
justicia	incorrección	ANT
amplificador	sintonizador	PART_OF
añadir	Hobby	RANDOM
rubio	Brunet	ANT
trama	guau	SYN
cuerpo	orden	RANDOM
barandilla	impedimento	HYPER
componer	calmar	HYPER
mercurio	miel	RANDOM
pez espada	pez espada	PART_OF
aptitud	falta de aptitud	ANT
agudo	obtuso	ANT
cruel	cayó	SYN
almohadilla	plataforma	HYPER
Dunker	alimentador	HYPER
corrimiento	deslizándose	SYN
endogamia	exogamia	ANT
presión	propulsión	HYPER
informado	no informado	ANT
empezar	vestir	RANDOM
sexy	unsexy	ANT
pasarela	paso	HYPER
dominación	maestría	SYN
cabeza de tambor	tambor	PART_OF
maldito	condenado	SYN
civilización	querido	RANDOM
chasis	homo	PART_OF
dique seco	astillero	PART_OF
exhalación	respiración	PART_OF
botón	Unión	RANDOM
compañeros	clan	HYPER
manzano silvestre	manzano silvestre	PART_OF
auberge	Posada	SYN
trayendo	entrega	SYN
apagar	ruta	PART_OF
desenmascarar	exponer	SYN
indigno de	digno	ANT
pollo	ignorancia	RANDOM
panza	torso	PART_OF
máximo	mínimo	ANT
rodilla	cuadrúpedo	PART_OF
irregularidad	regularidad	ANT
molestia	molestia	HYPER
mejor	peor	ANT
serpiente de cascabel	serpiente de cascabel	SYN
marchista	viajero	HYPER
marido	noche	RANDOM
camisero	salida	HYPER
extensión	flexión	ANT
eructo	ráfaga	HYPER
hueco	pálido	RANDOM
Molesto	roiled	SYN
tapiz	ornamentación	HYPER
curioso	extraño	SYN
crema	movimiento de piernas	SYN
intestino	Venter	PART_OF
centrífugo	centrípeto	ANT
radiestesia	predicción	HYPER
huella	tintura	HYPER
sangre	alguna cosa	RANDOM
ministro	ayudar	HYPER
coronilla	montaje	PART_OF
pimienta	pimienta	PART_OF
anotar	consejo	HYPER
copiloto	volante	HYPER
anoxemia	hipoxia	HYPER
serie	relación	HYPER
brócoli	vegetal	HYPER
bajo	instrumentista	HYPER
bozal	criatura	PART_OF
mantener	frase	RANDOM
tierra	satisfacción	RANDOM
pontón	anfibio	PART_OF
posdata	misiva	PART_OF
asalto	ataque	PART_OF
domar	salvaje	ANT
indicar	señal	SYN
renuencia	complacencia	ANT
chip	pata	RANDOM
separación	agrupamiento	HYPER
multilateralmente	unilateralmente	ANT
lírica	generoso	RANDOM
sin humo	ahumado	ANT
montón de heno	almiar	HYPER
acto	acera	RANDOM
eje	penacho	PART_OF
iniciativa	doncella	SYN
desleal	leal	ANT
recámara	barril	PART_OF
barrilete	bonito	HYPER
mesencéfalo	caput	PART_OF
iniciador	doncella	SYN
minuto	Corbata	RANDOM
cuenco	lanzar	RANDOM
seguido	sin caminos	ANT
aventuras	poner en peligro	SYN
nadir	cenit	ANT
fatiga	asignación	HYPER
agujero	calor	RANDOM
aventar	decidir	HYPER
escalera	escalera	PART_OF
descarte	exposición	HYPER
puente	gallo	RANDOM
hertz	kilohercio	PART_OF
oxígeno	canta	RANDOM
Misisipí	diseño	RANDOM
cuna	cuna	PART_OF
desmontaje	desmantelamiento	SYN
apresurado	sin prisas	ANT
Organo	visión	RANDOM
marinero	peón	SYN
pórtico	estructura	HYPER
mercurio	esposa	RANDOM
arrastrar	Lugger	PART_OF
exportar	importar	ANT
rombo	cuadrilátero	HYPER
cuesta arriba	ascenso	HYPER
fotosensibilidad	sentido	HYPER
movilizar	recoger	HYPER
abrigo	gastar	HYPER
cerca	tanque	RANDOM
cinchona	ladrar	HYPER
brecha	desacuerdo	HYPER
ratón	minuto	RANDOM
cremallera	vestido	PART_OF
historia	Universidad	RANDOM
poco	único	RANDOM
monitor	esqueleto	RANDOM
audición	audición	SYN
lo aburrido	nitidez	ANT
ex	último	ANT
agregador	coleccionista	SYN
almohadilla	canino	PART_OF
quinto	posición	HYPER
humano	apretado	RANDOM
entarimado	auto	PART_OF
llamada	regla	RANDOM
as	tiro caliente	SYN
desfile	paseo	SYN
techo	angustia	RANDOM
encontró	perdió	ANT
delincuencia	falta de pago	HYPER
meloso	almibarado	SYN
aborigen	primitivo	SYN
montones	fajos	SYN
cráneo	criatura	PART_OF
patio	muslo	PART_OF
insensible	sensato	ANT
esguince	giro	SYN
paloma	halcón	ANT
liquidador	alguien	HYPER
fuga	ascensor	RANDOM
guisante	guisante	PART_OF
naranja	cola	RANDOM
cuña	edificio	PART_OF
hoja	media	RANDOM
crudo	crudo	SYN
apoyarse en	colindar	HYPER
abadejo	abadejo	PART_OF
albardilla	edificio	PART_OF
empezar	Corbata	RANDOM
moderno	satisfacer	RANDOM
patada	retroceso	SYN
cadena	fuera de	RANDOM
encimera	mostrador	PART_OF
comprar	sostener	RANDOM
activo	historia	RANDOM
esperanza	aumento	RANDOM
intestino	estómago	PART_OF
puente	mortal	RANDOM
intruso	alguien	HYPER
flojedad	opresión	ANT
costero	interior	ANT
nudo	acero	PART_OF
atención	inatención	ANT
disciplina	indisciplina	ANT
viraje	guiñada	SYN
regateo	wrangling	SYN
sonar	sub	PART_OF
cruce de caminos	ruta	PART_OF
índice	aburrido	RANDOM
pasar	cigarrillo	RANDOM
inteligencia	estupidez	ANT
cuña	calzón chino	PART_OF
añadir	flor	RANDOM
noche	familia	RANDOM
llave	Moda	RANDOM
ambidextro	diestro	ANT
abundancia	escasez	ANT
alcaparra	fiesta	SYN
congelación	actividad	HYPER
riff	rápido	SYN
recauchutar	modificar	HYPER
colocado	inestable	ANT
concierto	gancho	HYPER
sólo	injusto	ANT
friso	zócalo	PART_OF
espalda	palabra	RANDOM
pavana	pavana	SYN
asistida	sin ayuda	ANT
concurrente	simultáneo	SYN
clavija	fijación	HYPER
merecidamente	inmerecidamente	ANT
dureza	rigidez	SYN
activación	inactivación	ANT
fortalecimiento	debilitación	ANT
silla	escritor	RANDOM
abertura	alcance	PART_OF
inferior	conectar	RANDOM
tinta	bajo	RANDOM
piñón	murciélago	PART_OF
bazar	salida	HYPER
grande	lado	RANDOM
ciudadano	no ciudadano	ANT
olor	oler	SYN
dama	cascada	RANDOM
máquina	justicia	RANDOM
flojo	tiempo	ANT
condensador	encendido	PART_OF
caña	cafetera	PART_OF
narración	informando	HYPER
deriva	rueda libre	SYN
escatimar	proporcionar	HYPER
aro	barril	PART_OF
frat	gremio	HYPER
divinidad	inmortal	SYN
verduras	vegetariana	HYPER
bodega	alivio	RANDOM
contaminado	sin contaminar	ANT
igualdad	desnivel	ANT
retículo	prismáticos	PART_OF
horizontal	inclinado	ANT
padre	pene	RANDOM
postrado	modificar	HYPER
balbucear	charla	HYPER
cremallera	pantalón	PART_OF
cubrir	actividad	HYPER
límite	límite	PART_OF
desviación	divergencia	SYN
estresado	átono	ANT
garaje	edificio	HYPER
anual	un año	SYN
malla	pie	PART_OF
flaco	cubierto de maleza	SYN
nitidez	blandura	ANT
medicina	conflicto	RANDOM
centralización	ensamblar	HYPER
hecho a medida	confeccionado	ANT
hacer descarrilar	socavar	HYPER
escápula	torso	PART_OF
liebre	liebre	PART_OF
de maniático	oferta	SYN
caminata	ir	HYPER
coño	torso	PART_OF
guante	homo	PART_OF
cambio	hombre	RANDOM
repetirse	recurso	SYN
rasguño	rascado	SYN
ombligo	torso	PART_OF
Nota	cargar	RANDOM
no quirúrgico	quirúrgico	ANT
41a	cuadragésimo primero	SYN
Caritativo	poco caritativo	ANT
Placekicker	pateador	HYPER
nivel	Fruta	RANDOM
pagar	retorta	SYN
augur	vidente	HYPER
Hermandad de mujeres	dorar	HYPER
convergencia	divergencia	ANT
biblioteca	actuación	RANDOM
cómoda	vivienda	PART_OF
civilización	creencia	RANDOM
rectificar	refinar	SYN
centavo	dobra	PART_OF
becerro	herramienta	RANDOM
olor fétido	maloliente	SYN
limón	limón	PART_OF
afirmativo	negativo	ANT
humanidad	mente	RANDOM
resección	operación	HYPER
poción	potable	HYPER
refinado	sin refinar	ANT
batería	ataque	HYPER
envío	mercancía	HYPER
explicable	inexplicable	ANT
serallo	serail	SYN
golf	jugando	HYPER
mostrador	vivienda	PART_OF
estratagema	conveniencia	SYN
circulo	redondo	SYN
sádico	desviarse	HYPER
incoherencia	sustancia	HYPER
Misisipí	programa	RANDOM
intercambio	transponer	SYN
detector	sintonizador	PART_OF
inseminación	cópula	PART_OF
Perfecto	encender	RANDOM
empujoncito	consumir	RANDOM
altanero	teatro	PART_OF
ministro	desperdicios	RANDOM
Beldame	bruja	SYN
conectado	desconectado	ANT
primero	último	ANT
mapa	honestidad	RANDOM
la desaceleración	modificación	HYPER
tablero	conjunto	RANDOM
cruzar	continuar	HYPER
distancia	estufa	SYN
honestidad	emoción	RANDOM
adorable	entrañable	SYN
descubridor	observador	SYN
moralismo	locución	HYPER
Trabajo escolar	labor	HYPER
velo	placenta	PART_OF
diferencial	cálculo	HYPER
organizado	desorganizada	ANT
implicar	preocupación	RANDOM
nabo sueco	sueco	PART_OF
articulación	película	RANDOM
asimilación	aprendizaje	HYPER
unilateralista	abogado	HYPER
atractivo	no atractivo	ANT
mililitro	ml	SYN
independencia	triste	RANDOM
Japón	visión	RANDOM
artificial	natural	ANT
línea	guay	RANDOM
insignificancia	significado	ANT
excluir	ausencia	HYPER
arrendamiento	fuera de	RANDOM
proscenio	teatro	PART_OF
visera	casco	PART_OF
coche	contaminar	RANDOM
tetera	tímpano	SYN
imagen	frase	RANDOM
espira	peinado	PART_OF
cola de golondrina	cruz	PART_OF
cincha	aprovechar	PART_OF
aburrimiento	salvar	RANDOM
tablero	recreación	RANDOM
bombardeo	batería	SYN
deberes	pedagogía	PART_OF
confidente	tímido	ANT
medio	recompensa	RANDOM
techo	maduro	RANDOM
ovario	flor	PART_OF
soledad	destrucción	HYPER
federal	unitario	ANT
tierra	recompensa	RANDOM
comprobar	en acción	HYPER
disonancia	armonía	ANT
quemar	político	RANDOM
productivo	improductivo	ANT
firmado	no firmado	ANT
mil	pulgada	PART_OF
inseminación	relación	PART_OF
marido	raro	RANDOM
conocimiento	enfermedad	RANDOM
becerro	caña	PART_OF
numérico	verbal	ANT
tocado	sin tocar	ANT
maravilloso	ordenado	SYN
subíndice	sobrescrito	ANT
hipertermia	hipotermia	ANT
que duda	escéptico	SYN
trimestre	quintal	PART_OF
formato	publicación	PART_OF
pájaro	mordedura	RANDOM
fructífero	sin fruto	ANT
equívoco	inequívoco	ANT
horrible	temible	SYN
entrepuente	navegación	PART_OF
bruscamente	rotundamente	SYN
futuro	retrospectivo	ANT
hámster	placentaria	HYPER
óseo	apretado	SYN
coherencia	incoherencia	ANT
acallado	expresado	ANT
aprobación	elogio	SYN
corredor	trineo	PART_OF
anatomía	homo	PART_OF
asalto	comienzo	PART_OF
hacer	enviar	SYN
peregrino	adorador	HYPER
justamente	injustamente	ANT
peristome	cápsula	PART_OF
lleno	sin llenar	ANT
arco	arco	SYN
atonalidad	tonalidad	ANT
baluarte	munición	PART_OF
evasivas	deshonestidad	HYPER
examinar	investigar	HYPER
delegando	administración	HYPER
captura	completo	RANDOM
desnudo	crudo	SYN
burlarse de	tratar	HYPER
no proliferación	proliferación	ANT
fabricar	agrio	RANDOM
samizdat	medio	HYPER
gunstock	artillería	PART_OF
escalada	exitoso	RANDOM
canal	ensillada	PART_OF
barandilla	Bannister	SYN
granate	pirotécnico	HYPER
coro	santuario	PART_OF
interino	letras	HYPER
lengüeta	plumaje	PART_OF
eco	resonar	SYN
mentira	niño	RANDOM
evadir	cobertura	SYN
exhortar	alentar	HYPER
vigor	empuje	SYN
patas	sin piernas	ANT
lente	error	RANDOM
dechado	variedad	HYPER
injerto	combinación	HYPER
orquesta	teatro	PART_OF
nariz	problema	RANDOM
conglomeración	montaje	HYPER
imagen	máquina	RANDOM
cuenta	humano	RANDOM
alerón	superficie sustentadora	HYPER
bólido	bola de fuego	SYN
delicadeza	nutrición	HYPER
alopátrico	simpátrico	ANT
cruce	cruce de caminos	SYN
suciedad	amabilidad	ANT
abertura	óculo	PART_OF
imagen	infeliz	RANDOM
playa	costa	PART_OF
guardarropa	usable	PART_OF
episodio	serie	PART_OF
sangre	Huelga	RANDOM
principal	infraestructura	PART_OF
mamífero	lesionar	RANDOM
monocromo	policromo	ANT
grieta	hendedura	HYPER
alcaparra	ligado	HYPER
nada	paz	RANDOM
esperanzado	sin esperanza	ANT
general	específico	ANT
proteger	molusco	PART_OF
cribado	artefacto	HYPER
caliente	carrera	RANDOM
muelle	puerto	PART_OF
redondo	concepción	HYPER
dramatizar	bordar	SYN
cambio	alterar	HYPER
celda	regalo	RANDOM
ilegitimidad	legitimidad	ANT
entrega	de serie	PART_OF
jefe	untado	RANDOM
sirsaca	textil	HYPER
minuto	contento	RANDOM
acariciante	excitación	HYPER
pepsina	Catalizador	HYPER
pollo	interesar	RANDOM
adjetivo	sustantivo	ANT
almohadilla	guante	PART_OF
descendencia	avión	RANDOM
frente	cráneo	PART_OF
recordar	interactuar	HYPER
intersección	ruta	PART_OF
barra oblicua	herida	HYPER
bígaro	bígaro	SYN
de serie	emisión	HYPER
puntal	pavonearse	SYN
sistemático	no sistemático	ANT
pulsera	manga	PART_OF
acuático	terrestre	ANT
enfermedad	móvil	RANDOM
quemar	casar	RANDOM
moretón	herida	HYPER
efector	receptor	ANT
desembolsar	transferir	HYPER
reducido	íntegra	ANT
protección personal	proteccion	HYPER
despertar	alterar	HYPER
tío abuelo	gran tío	SYN
rebeldía	dificultad	HYPER
dramático	lírica	ANT
no partidista	partidista	ANT
tocón	postigo	PART_OF
mayor	menor	ANT
indecente	impropio	SYN
Cada vez más	para siempre jamás	SYN
creíble	increíble	ANT
criptografía	criptología	SYN
Ratan	rota	SYN
exponer	descubrir	SYN
lejos	adelante	SYN
saturado	insaturada	ANT
brillo	lo aburrido	ANT
tintinar	trena	SYN
conferencias	curso	PART_OF
veraz	mentiroso	ANT
bar	salud	RANDOM
salto	compartir	RANDOM
enfurecer	despertar	HYPER
dispersión	extinción	PART_OF
ajuste	reajuste	SYN
clasificar	relegar	SYN
barrer	orbita	HYPER
me gusta	pagano	RANDOM
carril	ferrocarril	HYPER
pájaro	pandilla	RANDOM
homosexual	confianza	RANDOM
garganta	cuello	PART_OF
ferretero	salida	HYPER
tablón	pose	HYPER
mirilla	apertura	HYPER
cárcel	fe	RANDOM
agravio	actividad	HYPER
sacro	cadera	PART_OF
aventuras	diente	RANDOM
bollos	poder	SYN
previsibilidad	imprevisibilidad	ANT
gravedad	sinceridad	SYN
ahí	allá	SYN
pargo	pargo	PART_OF
empenaje	fuselaje	PART_OF
estrechamiento	ensanchamiento	ANT
hatful	mucho	SYN
papel	lápiz	RANDOM
montar a horcajadas	movimiento	HYPER
hacer	rock	RANDOM
articulación	me gusta	RANDOM
idioma	fijar	RANDOM
oferta	suministro	HYPER
mordimiento	Chomp	SYN
califa	khalifah	SYN
llevar	poderoso	RANDOM
aumentar	afilar	SYN
casa	prueba	RANDOM
fontanela	cráneo	PART_OF
cantante	compositor de canciones	SYN
amplio	pobre	ANT
bombardeo	ataque	HYPER
preocupante	movimiento	HYPER
convencido	convencido	ANT
llamativo	raído	SYN
firme	inexorable	SYN
colina	ignorancia	RANDOM
atípico	típico	ANT
cuidado	autopista	RANDOM
humanidad	poderoso	RANDOM
compañero	copla	PART_OF
adolescentes	edad adulta	PART_OF
alta resolución	baja resolucion	ANT
enlazar	texto	RANDOM
mediados de los setenta	años	PART_OF
irreverentemente	reverentemente	ANT
Correa	sostén	PART_OF
Oceano	trama	RANDOM
me gusta	esqueleto	RANDOM
Capitolio	edificio	HYPER
evaluación	evaluación	HYPER
gritando	declaración	HYPER
desestabilización	estabilización	ANT
homosexual	comunicar	RANDOM
distribuir	tambalear	SYN
ojete	féretro	PART_OF
bisagra	edificio	PART_OF
no racial	racial	ANT
micrómetro	mm	PART_OF
aspirar	enunciar	HYPER
estribillo	vocal	PART_OF
médula	alimento	HYPER
desaceleración	modificación	HYPER
prepucio	botón	PART_OF
impracticabilidad	sentido práctico	ANT
adecuado	inadecuado	ANT
bolígrafo	cosecha	RANDOM
cifrar	nulo	SYN
especificar	dilucidar	HYPER
umbilical	feto	PART_OF
opinar	prever	HYPER
abundante	satisfactorio	SYN
cóndilo	hueso	PART_OF
salida	problema	SYN
flintlock	flintlock	PART_OF
acosador	pie de página	HYPER
invertebrado	vertebrado	ANT
reemplazo	relleno	HYPER
cierto	incierto	ANT
veraniego	vernal	ANT
peligroso	que amenaza la vida	SYN
vendido	no vendido	ANT
apéndice	excrecencia	SYN
semblante	presencia	SYN
rap	grifo	SYN
bastante	sucio	ANT
legión	numeroso	SYN
truco	giro	SYN
líder	orden	RANDOM
pocos	muchos	ANT
vaina	avión	PART_OF
consumar	maestro	SYN
oscuridad	víspera	PART_OF
protuberancia	prominencia	HYPER
galera	avión de línea	PART_OF
croar	expirar	SYN
gravedad	ligereza	ANT
musa	rumiar	SYN
punk	sórdido	SYN
vestíbulo	comunicación	RANDOM
sintonizador	inalámbrico	PART_OF
labor	correo	RANDOM
carro	sano	SYN
pimienta de Jamaica	pimienta de Jamaica	PART_OF
bota	correr	RANDOM
pelota	hora	RANDOM
setenta	años	PART_OF
experimentador	siendo	HYPER
vertical	poste de la meta	PART_OF
afluencia	salida	ANT
r	diámetro	PART_OF
intestino	Venter	PART_OF
afecto	engranaje	RANDOM
coloso	de peso pesado	SYN
pista	tranvía	PART_OF
revender	transferir	HYPER
herir	relajarse	RANDOM
brutalmente	viciosamente	SYN
azafrán	azafrán	PART_OF
conservatismo	conservadurismo	SYN
igualdad	desnivel	ANT
caña	cabeza del palo	PART_OF
repatriar	nacional	HYPER
nanosegundo	milisegundo	PART_OF
adoptar	aceptar	HYPER
canto	subdivisión	HYPER
importar	viajero	HYPER
acción	chupar	RANDOM
flotador	jardines	HYPER
recommit	alcanzar	HYPER
Mira	árbol	RANDOM
evocador	fragante	SYN
burla	burla	SYN
en popa	delantero	ANT
sin carne	carnoso	ANT
rotor	estator	ANT
aprobación	sanción	SYN
cinturón	medicina	RANDOM
centrífugo	girar	HYPER
bloquear	reproducir	RANDOM
bajo	ver	RANDOM
capitalista	socialista	ANT
accionista	accionista	SYN
tipo	jeque	SYN
cincuenta	madurez	PART_OF
díscolo	refractario	SYN
sangre	pandilla	RANDOM
enfoque	abierto	RANDOM
lente	Moda	RANDOM
lapso	tránsito	PART_OF
Clavo	Clavo	PART_OF
salpicar	salpicaduras	SYN
jefe	ideología	RANDOM
hurra	aprobación	HYPER
borraja	borraja	PART_OF
retraso	sucediendo	HYPER
no partidista	partidista	ANT
cuenta	carne	RANDOM
corpóreo	incorpóreo	ANT
cavador	excavador	SYN
concluyente	inconcluyentemente	ANT
distinto	incisivo	SYN
hervir	giro	RANDOM
todavía	modificar	HYPER
delegar	designado	SYN
hábil	desmañado	ANT
canalón	esfuerzo supremo	SYN
barbarie	inhumanidad	HYPER
ít	simbólico	SYN
tesis	premisa	HYPER
esencia	sustancia	SYN
realeza	costo	HYPER
insuficientemente	suficientemente	ANT
perpetuo	incesante	SYN
mineral	corona	PART_OF
grupa	torso	PART_OF
compañero	lápiz	RANDOM
amueblado	sin muebles	ANT
seigneury	palanquilla	HYPER
parir	entregar	HYPER
cajón	aparador	PART_OF
compra	adquisitivo	SYN
articulación	protón	RANDOM
inmovilidad	movilidad	ANT
inspector	investigador	HYPER
queja	patada	HYPER
ocultar	revelando	ANT
antepasado	descendiente	ANT
as	rivalizar	HYPER
cumbre	excelente	SYN
actualmente	De Verdad	SYN
bordillo	bordillo	SYN
deprecating	slighting	SYN
proscripción	rechazo	HYPER
aterrizaje	edificio	PART_OF
calesa	loco	SYN
animar	evaluar	HYPER
microscópico	microscópico	SYN
me gusta	Oeste	RANDOM
cuerno	televisión	RANDOM
capitán	soldado	RANDOM
bulto	bache	SYN
vado	corriente de agua	PART_OF
aparejo	apagar	SYN
rechoncho	grueso	SYN
lisiado	cojo	SYN
atomismo	holismo	ANT
adhesión	pegajosidad	HYPER
invisibilidad	visibilidad	ANT
cordón	pasar	RANDOM
disuasión	persuasión	ANT
cárcel	derretir	RANDOM
candilejas	delantal	PART_OF
agua sucia	suministro	HYPER
estrechamiento	estrechándose	SYN
figura	alguien	PART_OF
De dos plazas	auto	HYPER
curandero	embaucador	HYPER
piquete	explorar	SYN
engranaje	motor	PART_OF
no esteroideo	esteroideo	ANT
atmósfera	débiles	RANDOM
bodrio	estropear	HYPER
techo	solado	ANT
cumpleaños	antiguo	RANDOM
submarinista	marinero	HYPER
gladiolo	tórax	PART_OF
cuenta regresiva	cuenta	HYPER
henil	granero	PART_OF
juez	bloquear	RANDOM
accesorio	suplemento	SYN
líquido	asqueroso	RANDOM
ceja	homo	PART_OF
extraversión	introversión	ANT
escudete	prenda	PART_OF
lápida sepulcral	tumba	PART_OF
destino	misiva	PART_OF
pecho	fumar	RANDOM
deducir	sustraer	SYN
antipatía	disgusto	SYN
alero	edificio	PART_OF
una pieza	dos piezas	ANT
aterrizaje	aterrizaje	HYPER
destino	sobrenatural	PART_OF
pasado	dolor	RANDOM
probable	potencial	SYN
flagelo	semen	PART_OF
sonido metálico	choque	SYN
característica	inusual	ANT
montaña	persona	RANDOM
ojete	manto	PART_OF
listón	celosía	PART_OF
mamón	suministro	HYPER
turboventilador	turboventilador	PART_OF
paleta	desplazar	HYPER
autorizado	autorizado	SYN
publicado	inédito	ANT
estómago	torso	PART_OF
sordo	audición	ANT
explosión	picota	SYN
cama	estudiar	RANDOM
adecuadamente	inapropiadamente	ANT
labor	alto	RANDOM
mezcla	pintar	RANDOM
inmuebles	nación	PART_OF
igualitario	elitista	ANT
analfabetismo	alfabetismo	ANT
reconsideración	repensar	SYN
naranja	diccionario	RANDOM
enfrentado	sin rostro	ANT
pesticida	cosas	HYPER
mil	dl	PART_OF
adaptador	mediación	HYPER
angular	redondeado	ANT
nivel	recompensa	RANDOM
proa	frente	HYPER
apartamento	sencillo	RANDOM
droga	zorrillo	SYN
armamento	encantador	ANT
degradado	libertino	SYN
no sectario	sectario	ANT
gancho	solicitar	SYN
erótica	pornografía	SYN
incorrectamente	correctamente	ANT
estaca	jugar	HYPER
exploración	replicación	HYPER
medio	Venus	RANDOM
aguilucho	malhechor	HYPER
no cumplir	tarjetas	PART_OF
marido	página	RANDOM
desfavorecer	actitud	HYPER
quitasol	abrigo	HYPER
burla	falta de respeto	HYPER
caso	cruel	RANDOM
en el extranjero	al campo	SYN
agencia	representación	SYN
explosión	explosiva	PART_OF
con plomo	sin plomo	ANT
drogadicto	adicto	SYN
inmadurez	madurez	ANT
posando	sentado	SYN
robando	robo	SYN
amistoso	altanero	ANT
que cae	creciente	ANT
adulto	llorar	RANDOM
chaqueta	sur	RANDOM
mala fama	reputación	ANT
bolígrafo	desagradar	RANDOM
colmillo	Jabali	PART_OF
inhibir	confinar	HYPER
cono	óptico	PART_OF
pelearse	hacer	SYN
ventaja	desventaja	ANT
fomentar	animar	HYPER
cláusula	papeles	PART_OF
diafragma	torso	PART_OF
extrusión	sobresalir	SYN
keister	torso	PART_OF
chip	débiles	RANDOM
pluma	puerco espín	PART_OF
cuarenta	edad adulta	PART_OF
fatal	fatídico	SYN
bota	raíz	RANDOM
súplica	oración	SYN
espalda	problema	RANDOM
teclado	casa	RANDOM
descolonización	descolonización	SYN
belleza	antiguo	RANDOM
sarcoma	cáncer	HYPER
disonancia	armonía	ANT
optimismo	pesimismo	ANT
conjuntiva	óculo	PART_OF
aprovechar	paracaídas	PART_OF
centavo	libra	PART_OF
movilizar	reunión	SYN
matón	punk	SYN
habitante	habitante	SYN
creencia	molécula	RANDOM
espejo	demostrar	HYPER
bahía	aeronave	PART_OF
recordar	recuperar	SYN
estilo	camino	SYN
pastorado	clero	HYPER
exaltación	zodíaco	PART_OF
improbabilidad	probabilidad	ANT
Aparecer	nieve	RANDOM
marioneta	figura	HYPER
cruce	ruta	PART_OF
papel de lija	abrasivo	HYPER
Bunter	masa	HYPER
optimista	pesimista	ANT
quinteto	montaje	HYPER
desconocido	alguien	HYPER
corteza	óptico	PART_OF
acortar	Pareja	RANDOM
heterocigóticos	homocigotos	ANT
clorofila	color	HYPER
nube	templado	RANDOM
tonterías	bobadas	SYN
infundado	salvaje	SYN
llamada	derretir	RANDOM
inteligencia	mensaje	HYPER
ojal	prenda	PART_OF
heterogeneidad	homogeneidad	ANT
distinguible	indistinguible	ANT
moderno	portón	RANDOM
chip	flexionar	RANDOM
níspero	níspero	PART_OF
cosmología	filosofía	HYPER
diafragma	torso	PART_OF
plantación	actividad	HYPER
warfarina	medicación	HYPER
nanómetros	micrómetro	PART_OF
ser más listo que	extralimitarse	SYN
líder	estelar	SYN
cuenco	bolos	PART_OF
admiración	gusto	HYPER
pegote	mugre	SYN
Fertilidad	esterilidad	ANT
conocido	desconocido	ANT
web	penacho	PART_OF
progresivo	regresivo	ANT
tourer	turista	SYN
fóvea	retina	PART_OF
berberecho	onda	SYN
no	sí	ANT
espada	diseño	RANDOM
cardenal	ordinal	ANT
ánodo	cátodo	ANT
heterosexual	suelo	RANDOM
reservado	no reservado	ANT
axón	neurona	PART_OF
beneficio	molécula	RANDOM
mentira	perezoso	RANDOM
pinchazo	eje	SYN
explosión	descarga	HYPER
sumergir	inmersión	HYPER
falta de pago	pago	ANT
huella dactilar	mar	HYPER
cuello	tornillo	RANDOM
cabo de desgarre	tolva	PART_OF
Irlanda	piso	RANDOM
profundidad	superficialidad	ANT
proyecto	visualizar	SYN
aptitud	falta de aptitud	ANT
calumnia	reducir	HYPER
Jubilación	yendo	HYPER
al vapor	picado	SYN
apreciación	depreciación	ANT
berma	ruta	PART_OF
Aparecer	bajo	RANDOM
cautivo	intención	SYN
enfoque	abajo	RANDOM
morfema	Constitucion	HYPER
enjuagar	emoción	SYN
zurullo	excreción	HYPER
juez	Iniciar sesión	RANDOM
GAM	manada	HYPER
cama	razón	RANDOM
pasado	tapa	RANDOM
excelente	premio	SYN
complejidad	sencillez	ANT
emergencia	freno	HYPER
patriota	nacional	HYPER
cornisa	entablamiento	PART_OF
aceleración	desaceleración	ANT
exprimir	limitado	SYN
persona que da la pauta	modelo	HYPER
deplorable	desdichado	SYN
Nuevo Méjico	mm	PART_OF
irritacion	provocación	SYN
ilegalidad	legalidad	ANT
inteligible	comprensible	SYN
dormitorio	vivienda	PART_OF
sacudir	artefacto	HYPER
papel	sombra	RANDOM
burlas	falta de respeto	HYPER
a regañadientes	de buena gana	ANT
pontífice	reverendo	HYPER
mezcla	escribir	RANDOM
bozal	bestia	PART_OF
pulgada	paso	PART_OF
cenador	ánima	SYN
puta	cerdo	HYPER
cordón	maduro	RANDOM
metro	hm	PART_OF
subsistencia	vivo	HYPER
táctico	planificador	HYPER
lomo	cuadrúpedo	PART_OF
tórax	artrópodo	PART_OF
griot	cuentista	HYPER
desinflación	inflación	ANT
cc	cl	PART_OF
dado	desdén	HYPER
encogimiento de hombros	movimiento	HYPER
caso	reciclar	RANDOM
salpicar	pulverización catódica	SYN
interior	al aire libre	ANT
examinar	sondeo	HYPER
paz	naranja	RANDOM
a la derecha	verso	ANT
prestatario	prestador	ANT
una pieza	De tres piezas	ANT
dispensar	tratar	HYPER
grande	confianza	RANDOM
insípido	sabroso	ANT
ilegítimo	legítimo	ANT
pectoral	torso	PART_OF
pico	infelicidad	RANDOM
carne de vaca	dividir	RANDOM
atlético	gimnástico	SYN
retículo	ocular	PART_OF
choque	suspensión	PART_OF
aceptablemente	inaceptablemente	ANT
potasa	cáustico	HYPER
creencia	idioma	RANDOM
escrúpulo	dracma	PART_OF
visor	alcance	PART_OF
Hola	Howdy	SYN
labor	añadir	RANDOM
astucia	astuto	SYN
oxígeno	paso	RANDOM
bañera	domicilio	PART_OF
película	transporte	RANDOM
túnel	paso	HYPER
Nota	almohada	RANDOM
Cálamo	Cálamo	PART_OF
telómero	núcleo	PART_OF
agradecido	desagradecido	ANT
faja	edificio	PART_OF
catalasa	proteína	HYPER
tímpanos	tímpano	SYN
ilegible	legible	ANT
homosexual	patata	RANDOM
alto	Gol	RANDOM
escucha	apretón	RANDOM
aliado	nación	HYPER
pito	Pancho	PART_OF
llano	Tweedy	SYN
culpa	inocencia	ANT
pene	vacío	RANDOM
humanidad	vida	RANDOM
tablero	emoción	RANDOM
cl	dl	PART_OF
trimestre	hora	PART_OF
irreligioso	religioso	ANT
claro	palabra	RANDOM
ingenua	dramático	HYPER
beneficio	sombrero	RANDOM
murciélago	presente	RANDOM
bloquear	ilustración	RANDOM
sembrar	emisión	HYPER
cordón	correo	RANDOM
alfalfa	alfalfa	SYN
mentira	televisión	RANDOM
aria	ópera	PART_OF
sedimento	pose	HYPER
capítulo	tierra	RANDOM
novio	sujetar	RANDOM
caliente	tanque	RANDOM
hacer clic	trinquete	PART_OF
impecable	inmaculado	SYN
extrasensorial	sensorial	ANT
anticiclón	ciclón	ANT
pulsera	prenda	PART_OF
agrado	disgusto	ANT
rastra	esquema	HYPER
picar	picazón	SYN
hipnotizado	hipnotizado	SYN
cadete	plebe	SYN
capó	cubierta	HYPER
cajón	mostrador	PART_OF
tiza	metanfetamina	SYN
barco	amante	RANDOM
entrometerse	incumplimiento	HYPER
hokey	sentimentaloide	SYN
degüelle	regurgitación	SYN
objeto	mar	RANDOM
eludir	esquivar	SYN
cinta	laureles	HYPER
ruina	percance	HYPER
anclaje	puerto	PART_OF
contento	descontento	ANT
Aparecer	noble	RANDOM
evaluar	medida	SYN
salón	habitación	PART_OF
aritmética	puente	RANDOM
calma	ingrediente	RANDOM
chaqueta	tipo	RANDOM
humildad	evento	RANDOM
fregar	limpiar	HYPER
descanso	sub	PART_OF
exogamia	endogamia	SYN
pixel	monitor	PART_OF
punzón	horquilla	HYPER
valiente	cascada	RANDOM
bocado	parte	PART_OF
alto	ideología	RANDOM
intolerancia	tolerancia	ANT
suposición	mejilla	HYPER
sirena	auto	PART_OF
deslealtad	lealtad	ANT
aguijón	instando	SYN
nostalgia	anhelo	HYPER
secretario	asistente	HYPER
perezoso	añadir	RANDOM
desastroso	fatídico	SYN
oficina	mobiliario	HYPER
trago	ingestión	HYPER
oscuridad	prominencia	ANT
místico	oculto	SYN
promiscuo	sin sentido	SYN
mimar	mimar	SYN
lubricante	lubricante	SYN
punta de lanza	eje	PART_OF
cuenco	hoja	RANDOM
cache	alijo	SYN
llave	proporcionar	HYPER
reserva	duda	HYPER
barandilla	balcón	PART_OF
jerarquía	esquema	PART_OF
sumersión	sumergimiento	SYN
dígito	vertebrado	PART_OF
caramelo	igual	RANDOM
oblicuidad	labor	PART_OF
asfixia	hipoxia	HYPER
incumbir	burla	HYPER
conocimiento	bonito	RANDOM
kc	megahercio	PART_OF
rendimiento	proporcionar	HYPER
programa	mensaje	HYPER
atún	atún	PART_OF
comprobado	a cuadros	SYN
destino	oculto	PART_OF
nacido	no nacido	ANT
benigno	maligno	ANT
tormenta de nieve	nevada	SYN
pollo	odio	RANDOM
feroz	furioso	SYN
magnético	magnetizado	SYN
comprensión	incomprensión	ANT
entrometerse	manosear	SYN
agujero	tener éxito	RANDOM
carta	alto	RANDOM
miembro	niño	RANDOM
enfoque	recompensa	RANDOM
marca	mejorar	RANDOM
exageración	dolores del parto	HYPER
ovoviviparous	vivíparo	ANT
inferior	enfriador	RANDOM
frivolidad	gravedad	ANT
portón	camión	PART_OF
no autorizado	gato montés	SYN
pluma	penacho	PART_OF
briony	brionia	SYN
forte	piano	ANT
pensativo	desconsiderado	ANT
estéril	no imaginativo	SYN
centro de la corriente	corriente de agua	PART_OF
optimista	pesimista	ANT
erótica	actividad	HYPER
dolores del parto	el embarazo	PART_OF
rocín	patada	HYPER
prudencia	sagacidad	HYPER
reclutar	conseguir	HYPER
anular	declarar	HYPER
arabesco	artefacto	HYPER
lb	quintal	PART_OF
rama	ignorancia	RANDOM
lápida mortuoria	lapso	PART_OF
cachorro	muchacho	SYN
chocolate	pieza	RANDOM
pérdida	sacrificio	SYN
entusiasta	sin entusiasmo	ANT
llevar	encender	RANDOM
tendencia	tendencia	HYPER
pontificado	administrar	HYPER
compañero	agua	RANDOM
nación	hora	RANDOM
húmedo	humedad	SYN
capítulo	vestido	RANDOM
teclado	inteligente	RANDOM
emocionante	unexciting	ANT
revestimiento de madera	edificio	PART_OF
formalidad	informalidad	ANT
Error	ratón	RANDOM
hockey	igual	RANDOM
imagina	esperar	HYPER
benedictino	licor	HYPER
ascensor	sexo	RANDOM
adulto	fijar	RANDOM
oxígeno	Servicio	RANDOM
civilidad	incivilidad	ANT
considerable	insignificante	ANT
preventivo	medicación	HYPER
baluarte	fortificación	PART_OF
exclusivo	inclusivo	ANT
tarjeta	póster	SYN
juzgar	juez	SYN
murciélago	integridad	RANDOM
boca	lápiz	RANDOM
idioma	ingrediente	RANDOM
quizás	posiblemente	SYN
esfuerzo	dolores del parto	SYN
llave	el maletero	RANDOM
memoria	almacenamiento	SYN
imbécil	torso	PART_OF
aditivo	sustractivo	ANT
intemperancia	templanza	ANT
mediados de los años veinte	madurez	PART_OF
grasa	manchar	SYN
suelto	sombra	RANDOM
langosta	saltamontes	HYPER
oficial	noncommissioned	ANT
hueso	útil	RANDOM
audio	teledifusión	PART_OF
clínica	hospital	PART_OF
bolita	frasco	PART_OF
vestíbulo	obtener	RANDOM
atmósfera	utilizar	RANDOM
hermano	hermana	ANT
vivacidad	afán	HYPER
armadura	más suave	PART_OF
bienes raíces	pertenencias	HYPER
Ginebra	espíritu	HYPER
berberecho	crujiente	HYPER
tablero	divorcio	RANDOM
sin fin	incesante	SYN
Organo	tren	RANDOM
masticación	alimentación	PART_OF
cultivado	culto	SYN
la falta de vivienda	estado	HYPER
transferir	transferencia	SYN
mejilla	caput	PART_OF
descubrir	darse cuenta	SYN
sopladura	cetáceo	PART_OF
mente	correcto	RANDOM
pellizco	punzada	SYN
bloquear	agrio	RANDOM
papel secante	cosas	HYPER
milímetro	centímetro	PART_OF
trepador	desmadejado	SYN
aprobación	desaprobación	ANT
noche	alquilar	RANDOM
de grano fino	en polvo	SYN
deshacer	frustrar	HYPER
tinta	viaje	RANDOM
empujoncito	homosexual	RANDOM
galera	arte	HYPER
peligro	la seguridad	ANT
dos tercios	fracción	HYPER
lírica	tornillo	RANDOM
voleo	emitir	HYPER
galón	pipa	PART_OF
pinza	crustáceo	PART_OF
jefe	pasado	RANDOM
playa	vestíbulo	RANDOM
indulgente	implacable	ANT
descendencia	salvaje	RANDOM
ligado	staccato	ANT
rever	examinar	HYPER
desestabilización	estabilización	ANT
confidente	alguien	HYPER
plastinación	preservación	HYPER
historia	idioma	RANDOM
cuerpo	tema	RANDOM
incauto	cauteloso	ANT
fiesta	fluir	RANDOM
odioso	amable	ANT
formal	informal	ANT
chocolate	anillo	RANDOM
abrazadera	vigorizante	SYN
sótano	incrementar	RANDOM
deformación	tejido	PART_OF
frente a	bofetada	PART_OF
consideración	fibra	PART_OF
activamente	pasivamente	ANT
diagonal	tablero de damas	PART_OF
caña	manillar	PART_OF
alterno	apoyo	HYPER
pánico	ansiedad	HYPER
espinilla	lucha	SYN
objetivo	camino	HYPER
bizco	apretado	SYN
equilibrado	inadaptado	ANT
amoroso	sin amor	ANT
importar	ver	RANDOM
centralizado	descentralizada	ANT
especialización	ajuste	HYPER
cargando	proporción	HYPER
pálido	extinguir	RANDOM
pedagogía	método	HYPER
barco	dinero	RANDOM
alargado	lineal	SYN
consola	pianoforte	PART_OF
denso	oscuro	SYN
comprometer	intransigente	ANT
entrada	lago	PART_OF
béisbol	cuadrado	RANDOM
guelt	polo	SYN
cárcel	ratón	RANDOM
matón	felón	HYPER
sin envolver	envuelto	ANT
interior	fuera de borda	ANT
cuesta abajo	elevación	PART_OF
noviazgo	solicitud	HYPER
pie	paso	PART_OF
servil	sumiso	SYN
reunir	pliegue	SYN
parcialidad	constelación	RANDOM
cubierta	automóvil	PART_OF
imprudencia	prudencia	ANT
mediados de los años cincuenta	edad adulta	PART_OF
deposito	tránsito	PART_OF
erección	artefacto	HYPER
falta del tiempo	el tiempo de actividad	ANT
mitad	agrupamiento	HYPER
ilegal	legal	ANT
oeste	Wester	HYPER
armar	arcilla	RANDOM
diferencia	igualdad	ANT
útil	sin objetivo	ANT
constitucional	inconstitucional	ANT
años	esperanza de vida	PART_OF
murciélago	despertar	RANDOM
estribo	estribo	SYN
cobertura	magnitud	HYPER
diapasón	laúd	PART_OF
piloto	motor	PART_OF
lírica	correr	RANDOM
privación de derechos	emancipación	ANT
interior	interior	SYN
entusiasmo	curiosidad	HYPER
creencia	hora	RANDOM
medio litro	galón	PART_OF
santiamén	izar	HYPER
música	anillo	RANDOM
acritud	humor	HYPER
espaciosidad	amplitud	SYN
cerebro	orquestar	SYN
cuidadoso	descuidado	ANT
existente	extinto	ANT
tontería	estupidez	SYN
general	especial	ANT
preámbulo	papeles	PART_OF
franco	Pancho	PART_OF
empezar	comunicación	RANDOM
impuesto por cada libra	apropiación	HYPER
steamroll	ir	HYPER
pez globo	pez globo	PART_OF
insignificante	maní	SYN
legalizar	legitimar	SYN
regulado	no regulada	ANT
trimestre	gestación	PART_OF
destello	exponer	HYPER
babushka	pañuelo	HYPER
picante	atributo	HYPER
programa	silaba	SYN
aprovechado	no explotado	ANT
menor	modesto	SYN
humano	patrón	RANDOM
actor	visión	RANDOM
huella dactilar	mancha	HYPER
sin piedad	sin piedad	SYN
tonelada	megatón	PART_OF
moler	mezcla	SYN
clero	laicado	ANT
ganancia	pérdida	ANT
pavonearse	gitano	HYPER
comba	convexidad	HYPER
manzana	líder	RANDOM
hacia abajo	hacia arriba	ANT
estimulando	instando	SYN
relleno	cigarro	PART_OF
claro	broncearse	RANDOM
desconcierto	mistificación	SYN
fructíferamente	infructuosamente	ANT
cuidado	metal	RANDOM
quemar	cárcel	RANDOM
giratorio	ruta	PART_OF
vena	manchar	HYPER
rambután	rambután	PART_OF
medio	idioma	RANDOM
demacrado	esquelético	SYN
chip	cultivar	RANDOM
posponer	retrasar	HYPER
mezcla	gritar	RANDOM
embotado	embotado	SYN
pedal	corriente	RANDOM
integrado	aislado	ANT
nanómetros	milímetro	PART_OF
sin par	Smo	SYN
imparcial	parcial	ANT
rehacer	remodelar	SYN
fuga	pan	RANDOM
sangre	nivel	RANDOM
niño	fluir	RANDOM
candidato	político	HYPER
ovario	florecer	PART_OF
constreñido	tenso	SYN
mons	vulva	PART_OF
engrandecimiento	elevación	SYN
físico	soma	SYN
ocupado	aluminio	RANDOM
ligero	mineral	RANDOM
fijo	no fijado	ANT
cohete	surgir	HYPER
lección	enseñando	PART_OF
eficacia	inoperancia	ANT
genital	venéreo	SYN
antepié	cuadrúpedo	PART_OF
tónico	bebida	HYPER
involucrado	no afectado	ANT
talentoso	sin talento	ANT
cortesía	comportamiento	HYPER
parcialidad	hueco	RANDOM
carga	burthen	SYN
saco	estructura	HYPER
amante de la naturaleza	alguien	HYPER
mapache	ringtail	SYN
contendiente	competidor	HYPER
chip	efecto	RANDOM
cuenco	seguir	RANDOM
casa	reproducción	RANDOM
coliflor	coliflor	PART_OF
pleno invierno	invierno	PART_OF
gota de agua	lluvia	PART_OF
homosexual	calor	RANDOM
distinto	indistinto	ANT
anfitrión	interactuar	HYPER
asignar	asignar	HYPER
rincón	edificio	PART_OF
sequedad	humedad	ANT
recuperación	reparación	HYPER
lamentable	lo siento	SYN
aficionado	profesional	ANT
dolor	alfiler	RANDOM
retraso	mientras tanto	SYN
agujero	humanidad	RANDOM
quebradizo	irrompible	ANT
perinatal	postnatal	ANT
bar	superficie	RANDOM
pedal	padre	RANDOM
tomar represalias	venganza	SYN
cebollino	cebollino	PART_OF
atención	inatención	ANT
útilmente	inútilmente	ANT
sesquicentenario	aniversario	HYPER
herencia	abstracción	HYPER
desmadejado	disperso	SYN
ambiguo	sin ambigüedades	ANT
esclerosis	patología	HYPER
núcleo	escalada	RANDOM
aficionado	profesional	ANT
inigualable	sin rivalidad	SYN
ojete	cubrir	PART_OF
negatividad	positividad	ANT
ligado	sin consolidar	ANT
hipoxia	asfixia	PART_OF
Australia	mismo	RANDOM
condición	experimentación	PART_OF
tonterías	babear	SYN
me gusta	línea	RANDOM
fuerza	debilidad	ANT
paga	borde	RANDOM
panorama	icono	HYPER
loco	chiflado	SYN
imaginación	amistoso	RANDOM
umbilical	feto	PART_OF
electroimán	circuito	PART_OF
charla	conversacion	HYPER
bagazo	brandy	HYPER
parcial	de colores	SYN
yugular	cuello	PART_OF
cálculo	matemáticas	HYPER
Timoteo	Timoteo	PART_OF
sin aros	montura	ANT
noventa	años	PART_OF
mamífero	carta	RANDOM
rebote	baloncesto	PART_OF
cargado	sin carga	ANT
responder	organismo	RANDOM
dorsal	ventral	ANT
disputa	freza	SYN
alto riesgo	especulativo	SYN
latigazo	óculo	PART_OF
Giro de vuelta	entrada de coches	PART_OF
defensivo	ofensiva	ANT
calificar	pronunciar	HYPER
aleta	figura	HYPER
manzana	sombrero	RANDOM
medicina	piso	RANDOM
reloj	medio	RANDOM
miligramo	dg	PART_OF
pulmón	subir	RANDOM
ex	último	ANT
pedicelo	pedículo	SYN
lesionar	tierra	RANDOM
término	infraestructura	PART_OF
cuidado	besos	SYN
conocimiento	ingrediente	RANDOM
agonista	antagonista	ANT
trabajo de clase	pedagogía	PART_OF
salto	amigo	RANDOM
excitar	estimular	SYN
arco	isla	RANDOM
Fermi	angstrom	PART_OF
nación	petróleo	RANDOM
trasplante	trasplante	SYN
patada	salto	HYPER
retrasar	Sostener	SYN
juramento	Dedicación	HYPER
línea de sangre	linaje	SYN
eglefino	eglefino	PART_OF
dolor de estómago	dispepsia	PART_OF
composición	colocación	HYPER
abrazadera	marco de referencia	PART_OF
privación de derechos	emancipación	ANT
cultivado	inculto	ANT
consagrar	santificar	SYN
policía	estriptista	SYN
diluvio	pila	HYPER
plural	singular	ANT
Envisioning	Ilustrando	SYN
reloj	libertad	RANDOM
Listo	no preparado	ANT
disuasión	persuasión	ANT
audacia	timidez	ANT
todo	intacto	SYN
hacer clic	amanecer	SYN
minuto	calcetín	RANDOM
gratificante	sin recompensa	ANT
lealtad	lealtad	HYPER
espolvorear	espolvorear	HYPER
farmacopea	montaje	HYPER
fosfatasa	enzima	HYPER
playa	enfermos	RANDOM
embrague	evocar	HYPER
mezcla	corresponder	HYPER
insospechadas	inimaginable	SYN
lesionado	ileso	ANT
novio	ordinario	RANDOM
caña	cuchillería	PART_OF
capítulo	monitor	RANDOM
pintar	ratón	RANDOM
belleza	fealdad	ANT
compuerta	compuerta	PART_OF
truco	bruto	HYPER
1940	cuarenta	SYN
intencionalmente	sin intención	ANT
impotencia	potencia	ANT
sayo	capa	HYPER
mariposa	romance	SYN
imaginación	sur	RANDOM
ruidoso	raído	SYN
alterado	inalterada	ANT
canal	dar	RANDOM
nave	zona	HYPER
ideal	nonsuch	SYN
reorganizar	organizar	HYPER
saliente	aliviado	SYN
hueco	yarda	RANDOM
borrador	reunión	SYN
blanqueador	alguien	HYPER
coroides	óptico	PART_OF
corriente	curso	HYPER
calle de rodaje	aeródromo	PART_OF
bolígrafo	hacha	RANDOM
resonante	rotundo	SYN
manus	homo	PART_OF
músculo extensor	flexor	ANT
tendinitis	tendinitis	SYN
pelota	gritar	RANDOM
composición	opus	SYN
lealtad	fidelidad	HYPER
mantequilla	bloquear	RANDOM
animal	escritor	RANDOM
críticamente	sin crítica	ANT
desproporcionado	proporcionado	ANT
China	conclusión	RANDOM
deductivo	inductivo	ANT
irreversibilidad	reversibilidad	ANT
popular	impopular	ANT
escanear	desnatar	SYN
yo	visión	RANDOM
adulto	dormir	RANDOM
Leche	igual	RANDOM
territorial	milicia	PART_OF
decremento	incremento	ANT
marcado	pronunciado	SYN
necesario	innecesario	ANT
Bigote	barba	PART_OF
cumpleaños	intercambiar	RANDOM
avanzar	amante	RANDOM
granizo	granizo	PART_OF
informativo	no informativa	ANT
parteluz	edificio	PART_OF
hambriento	sediento	ANT
periantio	florecer	PART_OF
admirar	texto	RANDOM
desinflación	inflación	ANT
matón	rufián	SYN
acuerdo	armonizar	SYN
activo	responsabilidad	ANT
canonizado	glorificado	SYN
copépodos	plancton	PART_OF
batalla	ganado	RANDOM
objeción	procedimiento	HYPER
queja	queja	PART_OF
cubierta	auto	PART_OF
barato	costosamente	ANT
hipócrita	falso	SYN
ingle	lomos	PART_OF
pagador	pagador	HYPER
cambio	manos	PART_OF
haz	gavilla	SYN
inhibido	desinhibido	ANT
ante todo	secundariamente	ANT
aniquilación	destrucción	HYPER
quemar	borde	RANDOM
estragón	Condimento	HYPER
acuoso	ígneo	ANT
boeuf	bueyes	PART_OF
impiedad	piedad	ANT
recuadro	insertar	HYPER
pedal	isla	RANDOM
Japón	juego	RANDOM
hereditario	patrimonial	SYN
agradablemente	desagradablemente	ANT
pálido	silencio	RANDOM
pájaro	tema	RANDOM
cuenta	traer	RANDOM
engrandecido	magnificada	SYN
labor	salvaje	RANDOM
extensión	pequeñez	ANT
asper	lira	PART_OF
clausura	narración	PART_OF
platija	tambalear	SYN
Mañana	petróleo	RANDOM
intervención	no intervención	ANT
poder	lavabo	PART_OF
que puede pensar	inconcebible	ANT
caído	caído	SYN
chalado	excéntrica	SYN
ampliar	gesto	HYPER
stomper	caminante	HYPER
anular	subyugar	SYN
caña	ancla	PART_OF
marca	acero	SYN
manto de chimenea	tubo de lámpara	PART_OF
composición	sustancia	HYPER
músculo extensor	flexor	ANT
definido	indefinido	ANT
bárbaro	incivilizado	SYN
populacho	público	SYN
art	raya	RANDOM
dama	todo	RANDOM
burlón	burlas	SYN
preservador	alguien	HYPER
culo	derriere	SYN
civilizado	cultivado	SYN
pubertad	juventud	PART_OF
alosa	alosa	PART_OF
Cyanamid	compuesto	HYPER
estambre	flor	PART_OF
ascensor	el plastico	RANDOM
palacio	esfera	PART_OF
dama	empujar	RANDOM
citar	crédito	SYN
hueco	posterior	RANDOM
homosexual	Produce	RANDOM
oportuno	inoportuno	ANT
incruento	sangriento	ANT
entre bastidores	en el escenario	ANT
extensión	flexión	ANT
dracma	libra	PART_OF
fidelidad	infidelidad	ANT
doble	soltero	ANT
antropomórfico	parecida a la humana	SYN
avanzar	miel	RANDOM
militante	Combatientes	SYN
borla	manguito	SYN
conjunto	desunido	ANT
plastrón	vestido	PART_OF
probóscide	elefante	PART_OF
castigado	impune	ANT
cumplidor	perdedor	ANT
pervertido	réprobo	HYPER
béisbol	viaje	RANDOM
trompetista	cisne	HYPER
sentido	darse cuenta	HYPER
ingenioso	simple	ANT
solitario	azotar	SYN
abotonado	desabrochada	ANT
codo	cubierta	HYPER
defensa	automóvil	PART_OF
nivel	plato	RANDOM
becerro	piel de becerro	SYN
teclado	medicina	RANDOM
desmovilización	movilización	ANT
relé	circuito	PART_OF
insinuante	insinuante	SYN
gene	núcleo	PART_OF
irreducible	reducible	ANT
desconcertante	nudoso	SYN
inaugural	inaugural	PART_OF
corriendo	operación	HYPER
Nebraska	bozal	PART_OF
ascensor	estado animico	RANDOM
Asia	fortuna	RANDOM
remuneración	nómina de sueldos	PART_OF
ayuda	vida	RANDOM
culo	detrás	SYN
America	chupar	RANDOM
heterosexual	almohada	RANDOM
ardiendo	un incendio	SYN
brazo	Menos	RANDOM
descansado	cansado	ANT
desenlace	resolución	HYPER
vestíbulo	sombra	RANDOM
marca	registro	HYPER
impropiedad	propiedad	ANT
naranja	nieve	RANDOM
acíclico	cíclico	ANT
juegos de palabras	ingenio	HYPER
vientre	torso	PART_OF
anterior	subsiguiente	ANT
oportunamente	inusualmente	ANT
eructos	propulsión	HYPER
69	sesenta y nueve	SYN
codicilo	será	PART_OF
garbanzo	vaina	HYPER
reja	automóvil	PART_OF
quintal	t	PART_OF
Wailer	desgraciado	HYPER
relajado	tiempo	ANT
responder	brillante	RANDOM
generosidad	generosidad	HYPER
primario	transformador	PART_OF
avión	encender	RANDOM
hg	kilo	PART_OF
victimizar	victimizar	HYPER
insolvencia	solvencia	ANT
literal	error de tipografía	SYN
cóccix	raquis	PART_OF
hueco	paseo	RANDOM
taconite	mineral	HYPER
nada	mismo	RANDOM
nártex	basílica	PART_OF
aliviar	calmar	SYN
concierto	entrada	PART_OF
premeditado	impremeditado	ANT
puerto	paseo marítimo	PART_OF
ruido	pierna	RANDOM
lomos	torso	PART_OF
geométricamente	linealmente	ANT
eddo	taro	SYN
pecho	jarra	RANDOM
diligente	negligente	ANT
forma de huevo	de forma ovalada	SYN
paralela	perpendicular	ANT
invasor	invasor	SYN
canapé	aperitivo	HYPER
penacho	robar	SYN
piedra de molino	molino de molienda	PART_OF
cambio	superior	RANDOM
caso	popular	RANDOM
microgramo	mg	PART_OF
bonito	bonito	PART_OF
oviducto	útero	PART_OF
arbustos	zona	HYPER
ir	no vayas	ANT
encargar	contar	HYPER
lengüeta	flecha	PART_OF
abundante	dando	SYN
entrometido	discreto	ANT
parte	niña	RANDOM
despejado	sin declarar	ANT
lesionar	objeto	RANDOM
amenazar	augur	HYPER
besuqueo	moldura	HYPER
carga	vejación	HYPER
jactarse	cuervo	SYN
iglú	choza	HYPER
admirar	cuenta	RANDOM
martillo	cabeza hueca	SYN
Interprete	software	HYPER
pie	barra	PART_OF
entrada	Grillo	PART_OF
abrazadera	dúo	SYN
ventilador	ventilación	PART_OF
popurrí	smorgasbord	SYN
rape	rape	PART_OF
infeccioso	patógeno	SYN
condensador	circuito	PART_OF
analizador	compilador	PART_OF
modelo	bipedestador	ANT
cps	kilohercio	PART_OF
encubiertamente	abiertamente	ANT
armado	sin brazos	ANT
salón	morada	PART_OF
Actriz	sombra	RANDOM
florecer	juventud	PART_OF
continuación	discontinuación	ANT
agudo	crónico	ANT
frecuente	infrecuente	ANT
comprar	cero	RANDOM
sospecha	insospechado	ANT
fallecimiento	toda la vida	PART_OF
babear	sin sentido	HYPER
herido	agrupamiento	HYPER
tipo	parte	RANDOM
cantera	objetivo	SYN
sin azúcar	azucarado	ANT
fauna	flora	ANT
corrupto	alterar	HYPER
rueda de carro	carro	PART_OF
ambicioso	sin ambición	ANT
céntimo	dirham	PART_OF
droga	pesa	SYN
conexión	alguien	HYPER
bbl	pipa	PART_OF
pulmón	cascada	RANDOM
curva	tranquilo	RANDOM
saltar	elemento	RANDOM
enamorado	cariño	HYPER
de mala fama	acreditado	ANT
supervisado	sin supervisión	ANT
pico	hostilidad	RANDOM
abertura	óptico	PART_OF
escarpado	virar	SYN
experto	competente	SYN
sin par	sin rivalidad	SYN
desarrollado	subdesarrollado	ANT
blues	canción folk	HYPER
bien definido	recortar	SYN
obligar	obligar	SYN
molinete	artefacto	HYPER
borroso	borroso	SYN
platija	soplador	PART_OF
semana de trabajo	semana	PART_OF
mapa	arbusto	RANDOM
llameante	maldito	SYN
ciliar	ciliado	SYN
conejera	chabola	SYN
fuerte	fortalecer	SYN
virutas de embalaje	embalaje	HYPER
formalismo	imitación	ANT
rumia	taco	SYN
dolor de estómago	indigestión	PART_OF
animosidad	odio	HYPER
lazo	lazo	PART_OF
discutible	discutible	SYN
garrapata	aracnoides	HYPER
Calosoma	escarabajo	HYPER
aduana	deber	HYPER
recluta	voluntario	ANT
equilibrar	desequilibrio	ANT
papel	sentar	RANDOM
impotencia	potencia	ANT
llevar	regatear	SYN
inspiración	respiración	PART_OF
venta	mercantilismo	HYPER
importar	cultivar	RANDOM
índice	separación	RANDOM
bidireccional	unidireccional	ANT
arrastrar	basura	PART_OF
Gumbo	Gumbo	PART_OF
florecer	palabra	RANDOM
fertilización	enriquecimiento	HYPER
afinar	alterar	HYPER
Passel	mucho	SYN
cajón	cómoda	PART_OF
optimismo	desesperación	ANT
no escrito	escrito	ANT
menos	más	ANT
lozano	exprimidor	HYPER
endrino	endrino	PART_OF
agitación	calma	ANT
tablero de damas	juego de damas	PART_OF
tectónica	arquitectura	PART_OF
inoperable	operable	ANT
alfabético	alfabético	SYN
prodigioso	incomparable	SYN
parroquia	obispado	PART_OF
enlazar	rock	RANDOM
nariz	valores	RANDOM
centavo	rupia	PART_OF
cambio	rascacielos	RANDOM
índice	césped	RANDOM
dirham	rial	PART_OF
grieta	hendedura	HYPER
suelto	puerta	RANDOM
milímetro	dm	PART_OF
enlazar	todo	RANDOM
metafase	mitosis	PART_OF
experimentado	inexperto	ANT
decrépito	enfermizo	SYN
cita	mobiliario	HYPER
asegurar	corroborar	HYPER
aislado	apartado	SYN
homosexual	aumento	RANDOM
con rapidez	despacio	ANT
melodía	melodía	SYN
exaltación	firmamento	PART_OF
llave	acueducto	PART_OF
rigidez	incapacidad	HYPER
cáncer	intercambiar	RANDOM
sospechar	siendo	HYPER
flexibilidad	inflexibilidad	ANT
caña	cucharón	PART_OF
salvaje	alguien	HYPER
timidez	la duda	SYN
clinch	agarrar	HYPER
indecisión	rasgo	HYPER
punk	cascado	SYN
plural	singular	ANT
fijación	plastinación	PART_OF
Cantalupo	Cantalupo	PART_OF
epítopo	antígeno	PART_OF
garabatear	garabato	SYN
Edda	taro	PART_OF
sen	yen	PART_OF
arco	común	RANDOM
conglomerado	corp	HYPER
captura	robar	RANDOM
techo	conflicto	RANDOM
civil	militar	ANT
Error	articulación	RANDOM
no prescripción	prescripción	ANT
cómoda	lavabo	PART_OF
la coordinación	subordinante	ANT
asesinato	seco	RANDOM
depurador	aparato	HYPER
temblor	ocurrencia	HYPER
constitutivo	orgánico	SYN
película	Foto	SYN
gatito	reunirse	RANDOM
jiujitsu	autodefensa	HYPER
monitor	saludable	RANDOM
propensión	propensión	SYN
cambio	tren	RANDOM
reprensión	reprimenda	SYN
carbón	fragmento	HYPER
salivar	codiciar	HYPER
hablador	hablador	SYN
extrovertido	introvertido	ANT
esfuerzo supremo	chorro	SYN
añorar	anhelar	HYPER
precocidad	inteligencia	HYPER
en total	totalmente	SYN
acortar	abierto	RANDOM
charla	visitar	SYN
lucio	thruway	SYN
novillos	absentismo escolar	SYN
apéndice	firmamento	PART_OF
avión	dinero	RANDOM
patólogo	médico	HYPER
coche	montaña	RANDOM
miembro	viaje	RANDOM
cumbre	elevación	SYN
paga	piedra	RANDOM
disciplina	alterar	HYPER
título de caballero	élite	HYPER
condicionalmente	incondicionalmente	ANT
bráctea	inflorescencia	PART_OF
escondido	fuera del pantalón	ANT
real	potencial	ANT
enérgico	refrescante	SYN
prenda	ropa	HYPER
cinturón de seguridad	automóvil	PART_OF
capucha	avión	PART_OF
hipertiroidismo	hipotiroidismo	ANT
responsabilidad	personalidad	PART_OF
amplificación	ganancia	SYN
cortesía	descortesía	ANT
grifo	barril	PART_OF
estabilizador	empenaje	PART_OF
malo	buque	RANDOM
cortar	recorte	HYPER
aumento	disminución	ANT
desmilitarizar	despojar	HYPER
película	bolígrafo	RANDOM
abrasador	virulento	SYN
dispensable	indispensable	ANT
exactitud	incorrección	ANT
corte	escozor	SYN
ciudad	desconocido	RANDOM
arrendamiento	real	RANDOM
periantio	flor	PART_OF
placenta	útero	PART_OF
ortopedista	médico	HYPER
art	escritor	RANDOM
mandioca	Gari	PART_OF
pasado	drama	RANDOM
Envío	mercantilismo	PART_OF
conversar	transpuesto	SYN
cuento	folklore	PART_OF
sangre	idea	RANDOM
explorar	diagnosticar	HYPER
agotado	sin escurrir	ANT
aburrimiento	sufrir	RANDOM
caja	metal	RANDOM
desincentivo	incentivo	ANT
desgracia	sucediendo	HYPER
ascender	crecer	RANDOM
descendencia	ilustración	RANDOM
Mira	Oceano	RANDOM
unirse	techo	RANDOM
contaminación	descontaminación	ANT
garbanzo	garbanzo	PART_OF
continuación	discontinuación	ANT
egoísmo	desinterés	ANT
escucha	chimenea	RANDOM
claridad	opacidad	ANT
líder	triángulo	RANDOM
rotor	refrigerador	PART_OF
desilusión	extraño	HYPER
curador	defensor	HYPER
parque	molécula	RANDOM
atleta	acción	RANDOM
curva	nada	RANDOM
demostrado	no probada	ANT
independencia	lugar	RANDOM
memo	alfeñique	HYPER
pecho	enfurecer	RANDOM
juez	cortar con tijeras	RANDOM
disimilitud	semejanza	ANT
protuberancia	médula	SYN
llevar	llevar	HYPER
señorita	criada	HYPER
calibre	longitud	HYPER
esperado	inesperado	ANT
prestamista	malhechor	HYPER
engañar	falsificación	HYPER
ateísmo	teísmo	ANT
media Luna	mes	PART_OF
aire-tierra	aire-superficie	SYN
extravagantemente	profusamente	SYN
despido	lanzamiento	SYN
gramo	trozo de cuero	PART_OF
tronco cerebral	caput	PART_OF
asiduo	patrón	HYPER
coral	himno	HYPER
Vanda	orquídea	HYPER
veleta	remo	PART_OF
de baja altitud	el nivel del mar	SYN
tapa	derretir	RANDOM
separación	ortografía	PART_OF
espiritual	mundano	ANT
bushel	trimestre	PART_OF
destruido	Preservado	ANT
desaprobación	sustancia	HYPER
aventurero	aventurero	SYN
brocado	elevado	SYN
Disparo	película	PART_OF
enfermedad	llorar	RANDOM
limpiar	ocio	RANDOM
apologético	sin complejos	ANT
cerdito	cerdito	SYN
amplificador	inalámbrico	PART_OF
Coco	palma de coco	PART_OF
no	sí	ANT
alegría	disposición	PART_OF
segmentación	maternidad	PART_OF
lámina	OS	PART_OF
escalada	solución	RANDOM
infringir	negar	SYN
asesinato	fluir	RANDOM
franqueo	sello	SYN
cable	telégrafo	SYN
ruidoso	clima	RANDOM
activo	unirse	RANDOM
presunción	humildad	ANT
herir	diseño	RANDOM
Fundación	explicación	PART_OF
girar	biselar	SYN
bar	barras	PART_OF
crujiente	crujiente	SYN
geocéntrico	heliocéntrico	ANT
llama	llamarada	SYN
pantano	situación	HYPER
céntimo	franco	PART_OF
exactitud	inexactitud	ANT
improbable	probable	ANT
congelado	no congelada	ANT
criminalización	despenalización	ANT
Rábano picante	Rábano picante	PART_OF
bunco	estafa	SYN
rescripto	escritura	HYPER
brillo	luminiscencia	SYN
hamburguesa	hamburguesa	PART_OF
grano de pimienta	pimienta	PART_OF
exponer	elaborar	HYPER
habló	rueda de carro	PART_OF
aneurin	tiamina	SYN
autor	pintar	RANDOM
Mañana	estudiar	RANDOM
asustadizo	nervioso	SYN
fulcro	palanca	PART_OF
escrúpulo	onza	PART_OF
suplicante	alegato	SYN
murciélagos	loco	SYN
murciélago	golpear	HYPER
caña	azotar	SYN
bendición	destino	HYPER
ruidoso	esconder	RANDOM
veleta	misil	PART_OF
masticar	carta	RANDOM
mareo	mareo	SYN
Japón	original	RANDOM
abyecto	miserable	SYN
fiesta	ver	RANDOM
irritabilidad	mal humor	SYN
desfallecer	balbucear	SYN
asegurar	tranquilizar	SYN
brillante	frío	RANDOM
transfiguración	modificación	HYPER
canonizar	ensalzar	HYPER
desvergüenza	robustez	HYPER
acortar	fijación	HYPER
mandíbula	tornillo	PART_OF
cenefa	tejido de alfombra	PART_OF
realista	poco realista	ANT
imbécil	ganso	SYN
guardaespaldas	suite	PART_OF
arco	edificio	PART_OF
adornado	sin adornos	ANT
robo	delito	HYPER
sobremarcha	el uso excesivo	SYN
capacidad	incapacidad	ANT
tiroteo	gunplay	SYN
BASIC	incidental	ANT
oso	llevar	HYPER
base	pie	SYN
próspero	rugido	SYN
almohadilla	manus	PART_OF
acomodar	proporcionar	HYPER
emocionante	todavía	ANT
Smo	considerar	HYPER
captura	espacio	RANDOM
decumbente	yacente	SYN
brisa	labor	HYPER
dictador	potentado	SYN
intercambio de favores	retortijón	HYPER
redada	incursión	HYPER
dólar	caballo	SYN
caudal	del dolor de la cabeza	ANT
razonable	irrazonable	ANT
abertura	apertura	HYPER
comprensión	incomprensión	ANT
endometrio	útero	PART_OF
ético	poco ético	ANT
valiente	cueva	RANDOM
razonablemente	excesivamente	ANT
anzuelo	implementar	HYPER
animar	temperamento	PART_OF
morir de hambre	sed	SYN
conciliar	aplacar	SYN
imaginación	prisión	RANDOM
agricultura	mercantilismo	HYPER
adivinar	hipótesis	SYN
consistente	inconsistente	ANT
especial	universal	ANT
orden	estado animico	RANDOM
dañado	intacta	ANT
latino	dhow	PART_OF
captura	disfrutar	RANDOM
adjuntar	sofá	RANDOM
barra	óptico	PART_OF
libra	quintal	PART_OF
zorro	embaucador	HYPER
casquete	cráneo	PART_OF
asignar	prorratear	SYN
ilegítimamente	legítimamente	ANT
directo	organizar	SYN
debido	indebido	ANT
clasificación	desclasificación	ANT
centavo	chelín	PART_OF
luneta	bóveda	PART_OF
cutícula	artrópodo	PART_OF
agonizante	horroroso	SYN
natural	antinatural	ANT
colmillo	elefante	PART_OF
Escoba	barrer	SYN
alineado	no alineada	ANT
cuerno	feo	RANDOM
seguir en	entrada	HYPER
lengüeta	punta de flecha	PART_OF
engañar	fascinar	SYN
de mierda	maloliente	SYN
mente	niño	RANDOM
socializar	socializar	SYN
rentable	improductivo	ANT
deflector	rompecabezas	SYN
exclamando	exclamación	SYN
perder	Oceano	RANDOM
RAID	ladrón	HYPER
crudeza	grosería	SYN
batalla	cielo	RANDOM
puntualidad	tardanza	ANT
muriendo de hambre	privación	HYPER
rastro	aprovechar	PART_OF
becerro	estrella	RANDOM
mezcla	paquete	RANDOM
trampa	traba	SYN
aplacar	aplastar	SYN
golpear	crema	SYN
mercado	profesor	RANDOM
acosar	molestia	HYPER
monstruosidad	mutación	HYPER
presidente	directo	HYPER
rallar	amargar la vida	SYN
mamey	mamey	PART_OF
esperanzado	alguien	HYPER
bolso	niñera	PART_OF
ocupado	jugador	RANDOM
comprar	magia	RANDOM
pico	cono	PART_OF
estrías	imprimir	HYPER
justicia	injusticia	ANT
bobo	alguien	HYPER
jugar	inversión	HYPER
formalmente	informalmente	ANT
agradable	desagradable	ANT
escucha	Oceano	RANDOM
bienal	dos año	SYN
radio	ciclo	PART_OF
establecimiento	régimen	PART_OF
estoma	traqueotomía	PART_OF
encuesta	homo	PART_OF
peldaño	escalera	PART_OF
negro	nuez	RANDOM
administrar	administrar	SYN
recinto	escritura	HYPER
orden	yarda	RANDOM
principiante	principiante	SYN
Klondike	solitario	HYPER
enano	hada	HYPER
mineral	corona	PART_OF
alto	coche	RANDOM
accidente	radio	RANDOM
sendero	comenzando	HYPER
físico	homo	PART_OF
laborioso	labor	HYPER
felizmente	tristemente	ANT
diagonal	en pendiente	SYN
semi	aparejo	PART_OF
sudar tinta	caminar penosamente	SYN
aceptación	crédito	SYN
medicina	brillante	RANDOM
alero	edificio	PART_OF
emocionante	inmóvil	ANT
Correa	cambio	PART_OF
nacimiento	articulación	RANDOM
artillería	armamento	HYPER
fibrosis	neumoconiosis	PART_OF
administración	autoridades	PART_OF
interesado	desinteresado	ANT
Gook	limo	SYN
playa	vehículo	RANDOM
miembro	transporte	RANDOM
créditos	Foto	PART_OF
BOD	chasis	SYN
resistor	circuito	PART_OF
caja	grano	RANDOM
matriarcal	patriarcal	ANT
curable	incurable	ANT
baño	desconocido	RANDOM
direccional	omnidireccional	ANT
tipo de	talador	SYN
acelerador	auto	PART_OF
capítulo	destruir	RANDOM
biblioteca	gallo	RANDOM
bostezo	bostezo	SYN
cremallera	vestido	PART_OF
musa	reflejar	SYN
frente	campo	PART_OF
enfado	agrio	RANDOM
sueño	estado	HYPER
bicicleta	flexionar	RANDOM
espada	magia	RANDOM
cargando	descarga	ANT
de coser	puntadas	SYN
debe	cosa	HYPER
labor	gestación	PART_OF
agrario	agricultura	SYN
abajo	piso de arriba	ANT
justicia	injusticia	ANT
Nuevo Méjico	milímetro	PART_OF
ombligo	Venter	PART_OF
abstinente	alguien	HYPER
golpear	escritura	HYPER
déficit	posesión	HYPER
categorizado	categorizado	SYN
gitano	gitano	HYPER
granero	estómago	SYN
incidente	episodio	PART_OF
compartimiento	satisfacer	RANDOM
rotor	lijadora	PART_OF
solapas	avión	PART_OF
DEP	apertura	HYPER
virtuosidad	capacidad	HYPER
tomate	tomate	PART_OF
esculpir	escultura	SYN
invulnerabilidad	vulnerabilidad	ANT
jak	yaca	PART_OF
civilización	escribir	RANDOM
atonalidad	tonalidad	ANT
cincuenta	edad adulta	PART_OF
autoclave	desinfectar	HYPER
fontanela	caja del cráneo	PART_OF
capítulo	detener	RANDOM
corteza	médula	ANT
auditor	oyente	SYN
treinta	edad adulta	PART_OF
determinador	cognición	HYPER
atenuación	sustancia	HYPER
desesperación	esperanza	ANT
aniónico	catiónico	ANT
nariz	disgusto	RANDOM
buzo	somorgujo	SYN
ladrar	azúcar	RANDOM
trastorno mental	desequilibrar	SYN
ramificación	bifurcan	PART_OF
colónica	irrigación	HYPER
identidad	memoria	HYPER
perder	paseo	RANDOM
pasillo	salir	RANDOM
inanidad	sin sentido	HYPER
boquilla	hocico	SYN
Añadir	suplemento	SYN
parcialidad	esposa	RANDOM
bombardear	desplazar	HYPER
novio	vagón	RANDOM
monstruo	monstruo	SYN
abdominal	torso	PART_OF
aparato	artilugio	SYN
ética	filosofía	HYPER
Butterball	gordo	SYN
organización	autoridades	PART_OF
impermanente	permanente	ANT
cuchara	retroexcavadora	PART_OF
juez	despertar	RANDOM
artista	estudiar	RANDOM
secularización	secularización	SYN
organizar	de acuerdo	HYPER
extensión	pequeñez	ANT
adición	sustracción	ANT
calma	dolor	RANDOM
vatio	caballo de fuerza	PART_OF
enfoque	castigo	RANDOM
binaural	monoaural	ANT
apertura	litosfera	PART_OF
decepcionante	culminante	ANT
caveat	comprador	SYN
homoerotismo	homosexualidad	SYN
bebé	Derecho	RANDOM
verbo	verbo	PART_OF
clamando	declaración	HYPER
articulación	fijar	RANDOM
puntuación	ortografía	PART_OF
cambio	transición	SYN
estafa	estafa	SYN
recluta	voluntario	ANT
reconocimiento	notación	HYPER
sufrimiento	miseria	HYPER
traje	persona de negocios	HYPER
desalentar	advertir	SYN
garra	crustáceo	PART_OF
rociar	chorro	HYPER
cruzar	hibridación	SYN
ahogo	aeronave	PART_OF
taxi	Taxi	SYN
zumbido	sonoridad	SYN
acondicionado	incondicional	ANT
llave	hora	RANDOM
aleluyas	tintineo	SYN
acidez	acidez	SYN
receptivo	unreceptive	ANT
bioma	comunidad	HYPER
oquedad	solidez	ANT
suerte	desafortunado	ANT
aguja	fonógrafo	PART_OF
inseguro	seguro	ANT
campesino	obrero	HYPER
en total	enteramente	SYN
aprender	salvaje	RANDOM
albardilla	edificio	PART_OF
tintura	color	HYPER
despertado	movido	SYN
pollo	tienda	RANDOM
gastos	gasto	HYPER
paciente interno	paciente externo	ANT
colchón	dormitorio	PART_OF
frustrar	bote	PART_OF
esperanzado	prometedor	SYN
cárcel	cubo	RANDOM
padre	llenar	RANDOM
centímetro	metro	PART_OF
marca	crear	RANDOM
vida	haz	RANDOM
insuficiente	suficiente	ANT
bicicleta	Servicio	RANDOM
promesa	situación	SYN
sector	economía	PART_OF
parte	comida	PART_OF
paliza	enorme	SYN
afinidad	consanguinidad	ANT
silenciar	dominar	HYPER
impulsivo	caprichoso	SYN
gamba	camarón	PART_OF
desaparecer	avanzar	HYPER
soma	alguien	PART_OF
música	vehículo	RANDOM
pasillo	metal	RANDOM
episodio	película	PART_OF
entre bastidores	en el escenario	ANT
distribuidor	afluente	ANT
borradura	el embarazo	PART_OF
pecho	real	RANDOM
utilidad	inutilidad	ANT
tuatara	reptil	HYPER
relacionado	no relacionado	ANT
enchufe	OS	PART_OF
civilización	agudo	RANDOM
fiel	infiel	ANT
China	grupo	RANDOM
ensamblar	recogiendo	SYN
oscuridad	noche	PART_OF
rienda	aprovechar	PART_OF
movimiento	habitación	RANDOM
profundo	superficial	ANT
aceptación	disposición	HYPER
judicial	autoridades	PART_OF
enjuague	Lavado	PART_OF
vida	empezar	RANDOM
no proliferación	proliferación	ANT
dm	presa	PART_OF
independencia	movimiento	RANDOM
pubis	cadera	PART_OF
nanómetros	micrón	PART_OF
atención	desatento inatención	ANT
marijuana	cáñamo	PART_OF
equilibrar	vender	RANDOM
fidelidad	infidelidad	ANT
arrebatado	rapsódico	SYN
zarza	Erica	HYPER
asignado	sin asignar	ANT
moribundo	esperanza de vida	PART_OF
sextante	circunferencia	PART_OF
kurus	lira	PART_OF
ruido	televisión	RANDOM
pelota	taburete	RANDOM
judicial	régimen	PART_OF
favoritismo	favoritismo	SYN
amoladora	hoagy	SYN
cúbico	planar	ANT
ir	decidir	HYPER
pomo	acero	PART_OF
idear	porque	HYPER
antiguo	limpiar	RANDOM
acolchado	artefacto	HYPER
honestidad	efectivo	RANDOM
Irlanda	profesor	RANDOM
profano	violar	SYN
creíble	increíblemente	ANT
cristiano	robar	RANDOM
imprinting	adquisición	HYPER
cabina	aeronave	PART_OF
bueno	bien	SYN
renovación	mejora	HYPER
Correa	camisa de señora	PART_OF
comparablemente	incomparablemente	ANT
popularización	degradación	HYPER
azotaina	corrección	HYPER
afirmación	inversión	ANT
parcialidad	mucho	RANDOM
fraternal	idéntico	ANT
fácil	acomodado	SYN
contralateral	ipsilateral	ANT
rábano	rábano	PART_OF
apresador	libertador	ANT
smiler	homo	PART_OF
restaurante	edificio	HYPER
número 100	centésimo	SYN
término	proposición	PART_OF
hielo	infeliz	RANDOM
moscatel	moscatel	PART_OF
declarativo	interrogativo	ANT
autólogo	homólogo	ANT
pretencioso	no pretencioso	ANT
ceremoniosamente	sin contemplaciones	ANT
destello	sucediendo	HYPER
parte	unidad	PART_OF
alcantarillado	infraestructura	PART_OF
remitente	anuncio	HYPER
caballero	avanzar	HYPER
interior	exterior	ANT
gobernar	decidir	HYPER
justicia	incorrección	ANT
gastos generales	transatlántico	PART_OF
óculo	caput	PART_OF
perseverar	preservar	HYPER
puntilla	embellecer	HYPER
trimestre	período	HYPER
enfado	nada	RANDOM
grieta	ruptura	SYN
padre	amabilidad	RANDOM
rebury	desplazar	HYPER
bebé	alfiler	RANDOM
himno	glorificar	HYPER
grieta	chasquido	SYN
artificial	irreal	SYN
reedición	transferir	HYPER
pista	ferrocarril	PART_OF
solidificación	plastinación	PART_OF
amnésico	alguien	HYPER
apartamento	incorrecto	RANDOM
confiabilidad	falta de fiabilidad	ANT
horrible	horrible	SYN
canabis	tarro	RANDOM
agrandar	aumentar	SYN
confinado	invasor	ANT
rama	correo	RANDOM
Irlanda	Luna	RANDOM
consumo	finalizando	HYPER
asqueroso	desagradable	SYN
ilícito	lícito	ANT
salvación	entrega	HYPER
decisivo	indeciso	ANT
anhidro	hidratado	ANT
intelecto	alguien	HYPER
adular	arrastrarse	SYN
intemperancia	templanza	ANT
agitar	invitación	HYPER
orgulloso	triunfal	SYN
sin sazonar	no probado	SYN
exageración	atenuación	ANT
ruidosamente	tranquilamente	ANT
imitación	simulado	SYN
propina	cono	PART_OF
baño	música	RANDOM
impropiedad	propiedad	ANT
pobre	Rico	ANT
raquis	tallo	HYPER
cegador	deslumbrante	SYN
revista	depositario	HYPER
pista	aeródromo	PART_OF
intensificador	modificador	HYPER
caña	espátula	PART_OF
menopausia	madurez	PART_OF
bolero	terpsichore	HYPER
asfixia	finalizando	HYPER
eficazmente	ineficazmente	ANT
anclaje	refugio	PART_OF
contrarrestar	subvertir	SYN
fijaciones	nutritivo	HYPER
rasguño	borrar	HYPER
dispersión	actividad	HYPER
ascender	fe	RANDOM
defecto	mar	SYN
hipertensión	hipotensión	ANT
extramuros	intramural	ANT
decelerar	disminuir	HYPER
masa	lío	SYN
fárrago	mezcolanza	SYN
certificado	sin certificar	ANT
hertz	megahercio	PART_OF
chip	ventilador	RANDOM
hombre	cacerola	RANDOM
coroides	óculo	PART_OF
trimestre	Superior	PART_OF
boca	retirar	RANDOM
rostro	homo	PART_OF
familiar	genético	SYN
artilugio	mediación	HYPER
eddo	taro	PART_OF
afecto	palo	RANDOM
trabajando	artefacto	HYPER
empapar	compensación	SYN
vida	tema	RANDOM
diacrónico	sincrónico	ANT
China	mascota	RANDOM
objetivamente	subjetivamente	ANT
derrotista	escéptico	HYPER
reja	auto	PART_OF
oscuridad	recordar	PART_OF
zoquete	alguien	HYPER
quintal	tonelada	PART_OF
inmersión	ocultación	PART_OF
Estar atento	artefacto	HYPER
distribución	márketing	PART_OF
desgaste	esfuerzo	HYPER
menos	Más	ANT
brote	brote	HYPER
Noticias	maceta	RANDOM
primitivo	alguien	HYPER
anisótropo	isotrópico	ANT
terrestre	prosaico	SYN
capitalismo	socialismo	ANT
prohibir	edicto	HYPER
pico	Por favor	RANDOM
debut	Introducción	SYN
dureza	blandura	ANT
crítico	sin juzgar	ANT
Mañana	tiempo de día	PART_OF
grifón	buitre	HYPER
puerto	enfermera	SYN
chalote	chalote	PART_OF
Boda	ceremonia	HYPER
Cuarto	lavabo	RANDOM
estable	inestable	ANT
confab	conferir	SYN
concepción	Idea equivocada	ANT
silla	separación	RANDOM
tipo	feo	RANDOM
empuñadura	daga	PART_OF
circular	giratorio	SYN
caoba	sepia	SYN
cerciorarse	comprobar	SYN
antiguo	casco	RANDOM
bañera	habitación	PART_OF
travestido	siendo	HYPER
atenuado	undimmed	ANT
apuntador	asistente	HYPER
tamarindo	tamarindo	PART_OF
canal	servir	RANDOM
lontananza	principal	PART_OF
fisonomía	homo	PART_OF
borde del camino	tránsito	PART_OF
llave	arcada	PART_OF
espesor	delgadez	ANT
entrenado	inexperto	ANT
anterógrada	retrógrado	ANT
probóscide	mamut	PART_OF
oblicuidad	maternidad	PART_OF
sobreabundancia	cantidad	HYPER
campo central	jardines	PART_OF
garantía	endosar	HYPER
jerarquía	gobernancia	PART_OF
armamento	desarmamiento	ANT
fuente	grafema	HYPER
estruendo	sonar	SYN
acortar	reproducción	RANDOM
molestia	pelea	SYN
bragas	innombrable	HYPER
corriendo	trabajando	SYN
economía	agrupamiento	HYPER
balsámico	loco	SYN
metafísica	humanidades	HYPER
cautivados	en trance	SYN
mezcla	calle	RANDOM
educación	patrimonio	HYPER
caja	autobús	RANDOM
ministro	valores	RANDOM
separatista	alguien	HYPER
conservatorio	edificio	HYPER
interpolación	interposición	SYN
privilegiado	desamparado	ANT
banalidad	bromuro	SYN
caña	grifo	PART_OF
agrado	disgusto	ANT
Actriz	esposa	RANDOM
capucha	cámara	PART_OF
sotavento	barlovento	ANT
Sartor	Sastre	SYN
abstractamente	concretamente	ANT
fuga	pistola	RANDOM
kilohercio	megahercio	PART_OF
gunstock	batería	PART_OF
ambidextro	zurdo	ANT
chisporroteo	lucha	SYN
hoja	recreo	RANDOM
corporal	somático	SYN
generalista	especialista	ANT
no fumador	fumador	ANT
maelstrom	corriente	HYPER
afirmación	inversión	ANT
figura	suelo	ANT
comercializador	vendedor	SYN
caso	televisión	RANDOM
popularidad	impopularidad	ANT
grande	común	RANDOM
art	orgullo	RANDOM
flexible	de cera	SYN
aterrizaje	escalera	PART_OF
fabricar	pregunta	RANDOM
artista	sufrir	RANDOM
arrojar	torno	PART_OF
patán	palurdo	SYN
matón	malhechor	HYPER
decencia	indecencia	ANT
justicia mayor	juez	HYPER
proximidad	contigüidad	SYN
pulmón	valor	RANDOM
pasar	escupir	RANDOM
demacrado	apretado	SYN
impávido	impertérrito	SYN
renuencia	complacencia	ANT
compensación	restitución	SYN
fortalecimiento	debilitación	ANT
crucero	Iglesia	PART_OF
traqueteo	serpiente de cascabel	PART_OF
cátedra	catedral	PART_OF
inferioridad	superioridad	ANT
oprimir	ortiga	HYPER
carne	sólido	RANDOM
despido	liberación	SYN
Al por menor	venta al por mayor	ANT
biggin	tocado	HYPER
aptitud	competencia	HYPER
onza	lb	PART_OF
novato	licenciatura	HYPER
egoísmo	desinterés	ANT
poder	privado	PART_OF
delantal	teatro	PART_OF
hipnotizado	hechizado	SYN
baño	descender	RANDOM
aislado	embargado	SYN
visor de bombardeo	monumentos	HYPER
destello	llamativo	SYN
contrapeso	diferir de	HYPER
contenido	publicación	PART_OF
contracción	expansión	ANT
así	thusly	SYN
provocador	agente	HYPER
conveniencia	artilugio	SYN
cercanía	cercanía	SYN
libertad condicional	lanzamiento	HYPER
apilar	pose	HYPER
eficaz	eficaz	SYN
angstrom	micrómetro	PART_OF
irritante	irritable	SYN
máximamente	mínimamente	ANT
ética	moralidad	SYN
cinturón	saber	RANDOM
panapen	panapen	PART_OF
fértil	estéril	ANT
huso	parte	HYPER
cartel	póster	SYN
movimiento	descendencia	RANDOM
magneto	encendido	PART_OF
masculino	toque	RANDOM
lesionar	llegar	RANDOM
rotor	estator	ANT
laboreo	agricultura	PART_OF
centavo	sucre	PART_OF
respaldo	automóvil	PART_OF
arrestar	detener	SYN
fibra	alguien	PART_OF
sublimado	sublime	SYN
increíble	plausible	ANT
paso	Furlong	PART_OF
ahorrativo	antieconómico	ANT
de recorrido	esquiar	PART_OF
mental	físico	ANT
equidad	falta de equidad	ANT
mente	raro	RANDOM
desarrollando	desarrollo	SYN
por mal camino	amplio	SYN
bollos	torso	PART_OF
distribuir	desnudo	HYPER
delirante	emocionado	SYN
orden	enfermos	RANDOM
muerto	vivo	ANT
bronceado	eritema	HYPER
líquido	portón	RANDOM
galante	hinchar	SYN
barrer	enredo	SYN
cerebro	película	RANDOM
criminalización	gobernancia	HYPER
dorado	dorado	SYN
experto	letrado	SYN
masculino	piedra	RANDOM
circulo	limpiar	RANDOM
pierna	película	RANDOM
crítica	crítica	SYN
movimiento	adulto	RANDOM
lectura concienzuda	estudiando	SYN
analítico	sintético	ANT
monoteísmo	politeísmo	ANT
motorizado	sin alimentación	ANT
digestión	aprendizaje	HYPER
neutrinos	leptón	HYPER
campo	arena	PART_OF
compromiso	guerra	PART_OF
rotor	turbina	PART_OF
brillante	esposa	RANDOM
envainada	desenvainado	ANT
boeuf	vacas	PART_OF
estimar	adivinar	SYN
mayor	menor	ANT
druthers	alternativa	HYPER
sesenta	años	PART_OF
glúteo	torso	PART_OF
finalizando	narración	PART_OF
congruente	incongruente	ANT
trazador	oficial	HYPER
sinapsis	nervio	PART_OF
hilván	asado	PART_OF
Supercilium	caput	PART_OF
directo	inverso	ANT
convocar	convocar	SYN
local	nacional	ANT
tierras altas	tierras bajas	ANT
epílogo	escritura	PART_OF
aceptablemente	tolerablemente	SYN
tornillo	cabeza	RANDOM
imperecedero	perecedero	ANT
engañar	cultivo	RANDOM
impermanencia	permanencia	ANT
estator	turbina	PART_OF
celda	hierba	RANDOM
avanzar	contaminar	RANDOM
aceptación	aprobatorio	HYPER
salpicaduras	pulverización catódica	SYN
ruptura	perturbación	SYN
núcleo	médula	SYN
balancearse	patio de recreo	PART_OF
dragar	draga	PART_OF
insubstancial	sustancial	ANT
eje	pilar	PART_OF
dolor	hombre	RANDOM
caja de resonancia	piano	PART_OF
proyecto	tarea	SYN
mediados de los setenta	años	PART_OF
centralizar	concentrado	SYN
afirmativo	negativo	ANT
pedal	ola	RANDOM
escolta	preservador	HYPER
tiro	principiante	SYN
quemar	chamuscar	SYN
hermosa	asiento	RANDOM
bar	minuto	RANDOM
perspectiva	analizar	HYPER
expulsar	lanzamiento	SYN
enterrado	sin enterrar	ANT
traficante en dinero	comerciante	SYN
consagración	compromiso	HYPER
disuasivo	persuasivo	ANT
principado	región	HYPER
estructuralismo	sociología	PART_OF
canal	mueble	RANDOM
omitir	eliminar	HYPER
masculleo	enunciación	HYPER
moderadamente	bonita	SYN
glowering	hosco	SYN
cooperativa	cooperativa	SYN
adhesión	enlace	SYN
balancín	patio de recreo	PART_OF
cinturón	perezoso	RANDOM
pestaña	párpado	PART_OF
pájaro	puro	RANDOM
salario	nómina de sueldos	PART_OF
fiesta	responder	RANDOM
jerarquía	régimen	PART_OF
cordón	morir	RANDOM
maldito	restaurar	HYPER
funcional	orgánico	ANT
consciente de	desconsiderado	ANT
formular	exprimir	HYPER
general	universal	SYN
paso	para caminar	PART_OF
BOD	soma	SYN
Bonk	jazz	SYN
avión	mitad	RANDOM
jerarquía	organización	PART_OF
accesorio	arreglar	SYN
grande	gratis	RANDOM
sangre	descendencia	SYN
locura	cordura	ANT
vibrar	evocar	HYPER
beneficio	amistoso	RANDOM
humanista	abogado	HYPER
centavo	florín	PART_OF
trasero	torso	PART_OF
último	más baja	SYN
discriminar	indistinto	ANT
micrómetro	centímetro	PART_OF
arco	edificio	PART_OF
mal definido	bien definido	ANT
zorro	piel	HYPER
pájaro	exitoso	RANDOM
picar	humilde	RANDOM
desalentador	alentador	ANT
intemperante	templado	ANT
estilo de vida	camino	HYPER
cursos	curso	PART_OF
cuadrícula	acumulador	PART_OF
salamandra	anfibio	HYPER
antebrazo	brazo	PART_OF
arenque	arenque	PART_OF
abrazo	hacerse un nido	SYN
desmañado	sin gracia	SYN
ceguera	discapacidad	HYPER
decisión	indecisión	ANT
vestíbulo	edificio	PART_OF
encima	abajo	ANT
compacidad	densidad	SYN
America	Puerto	RANDOM
clase	Servicio	RANDOM
desobediencia	obediencia	ANT
hermandad	organización	HYPER
carro	mecanismo	HYPER
corruptible	venal	SYN
efusivo	gushy	SYN
nombres	menosprecio	HYPER
portador	inmune	HYPER
fertilizante	cosas	HYPER
haba de soja	soja	PART_OF
pene	hora	RANDOM
base	tubo	RANDOM
corpulento	pesado	SYN
carril	balcón	PART_OF
hockey	querido	RANDOM
calle de rodaje	campo	PART_OF
exceso	proporcionar	HYPER
borrador	tracción	HYPER
casco	ungulado	PART_OF
enamorado	prendado	SYN
ir	deletrear	SYN
rubicundo	escarlata	SYN
excepción	ejemplo	HYPER
barandilla	Bannister	PART_OF
limitado	especial	SYN
pedal	minuto	RANDOM
proceso de dar un título	autorización	HYPER
manteca de cerdo	engañar	HYPER
ujier	oficial	HYPER
zodíaco	Cielos	PART_OF
enlazar	nada	RANDOM
abdominal	vientre	PART_OF
arrastrar	sendero	SYN
imposibilidad	posibilidad	ANT
autorizado	no autorizado	ANT
coala	zarigüeya	HYPER
Leche	nublado	RANDOM
metro	métrico	HYPER
maldito	bushel	HYPER
estímulo	estímulo	SYN
silla	lápiz	RANDOM
barandilla	pretil	SYN
yo	naturaleza	RANDOM
cámara	domicilio	PART_OF
clasificación	tanteo	SYN
adagio	dueto	PART_OF
fiesta	alondra	SYN
bunco	estafar	SYN
paseo	paseo	SYN
arrendamiento	conclusión	RANDOM
comprensible	incomprensible	ANT
episódico	ocasional	SYN
sabroso	desagradable	ANT
saltar	salir	RANDOM
postquemador	turbohélice	PART_OF
nacimiento	ejercicio	RANDOM
séquito	séquito	SYN
pelea	lucha	HYPER
ociosidad	pereza	HYPER
cinturón	dulce	RANDOM
deshonesto	honesto	ANT
desertor	renegado	SYN
diez	tenner	SYN
atractivo	no atractivo	ANT
pináculo	cumbre	SYN
fácil	holgado	SYN
chocolate	miembro	RANDOM
adquisitivo	compra	HYPER
dolor	contento	RANDOM
grandeza	esplendor	SYN
bodega	dedo del pie	RANDOM
oblicuo	perpendicular	ANT
corpiño	vestido	PART_OF
rozar	vejar	SYN
vulgar	deteriorado por el tiempo	SYN
aventuras	Moda	RANDOM
violación	violación	SYN
materno	paternal	ANT
origen	fuente	HYPER
Jati	estrato	HYPER
reposacabezas	automóvil	PART_OF
endosar	sanción	HYPER
base	cabeza	RANDOM
competente	incompetente	ANT
tush	torso	PART_OF
casbah	kasbah	SYN
satirizar	parodia	SYN
tranquilidad	calma	HYPER
concienzudo	escrupuloso	SYN
reserva	reservas	SYN
alto	orden	RANDOM
lugar de nacimiento	cuna	SYN
bonanza	bendición	SYN
narración	pesado	SYN
no partidista	partidista	ANT
lyssa	rabia	SYN
cohete	proyectil	PART_OF
desobediente	obediente	ANT
grande	agudo	RANDOM
sertralina	antidepresivo	HYPER
fatal	no fatal	ANT
anfitrión	parásito	ANT
aparador	vivienda	PART_OF
palanqueta	palanca	HYPER
fama	infamia	ANT
cabina	corredor	PART_OF
ligero	lanzar	RANDOM
aceptación	rechazo	ANT
capitán	paciente	RANDOM
igualdad	desigualdad	ANT
queja	queja	HYPER
evaluación	juicio	HYPER
engrandecimiento	aumentar	HYPER
marcar	cronometrador	PART_OF
exageración	atenuación	ANT
cáñamo	horca	PART_OF
lápida sepulcral	lápida sepulcral	SYN
catalogar	clasificar por categorías	HYPER
trígono	trinidad	SYN
aguacero	tromba marina	SYN
fluidez	liquidez	SYN
milla	liga	PART_OF
conformista	inconformista	ANT
Disparo	Foto	PART_OF
fiscal	oficial	HYPER
acción	forma	RANDOM
alerta	enérgico	SYN
de confianza	no fidedigno	ANT
adornar	alterar	HYPER
lente	profesor	RANDOM
mercurio	amistoso	RANDOM
embolia	calendario	PART_OF
flúor	fluorita	SYN
historia	pálido	RANDOM
malo	reciclar	RANDOM
tornillo	parte	RANDOM
agravación	provocación	SYN
codo	tubo	HYPER
idiosincrasia	manierismo	SYN
alimentar	transferir	HYPER
multiculturalismo	nacionalismo	ANT
asociado	adjunto	SYN
empuje	movimiento	HYPER
mentira	Menos	RANDOM
enchilada	sustento	HYPER
efectuar	hacer	HYPER
Vieira	Vieira	PART_OF
oscuro	débil	SYN
decisión	indecisión	ANT
exilio	forastero	HYPER
adecuación	insuficiencia	ANT
sprint	cremallera	HYPER
cilantro	cilantro	PART_OF
monoteísta	politeísta	ANT
brazo	frase	RANDOM
revitalización	renacimiento	SYN
muelle	muelle	HYPER
diurno	nocturno	ANT
unirse	desagradable	RANDOM
impermeable	permeable	ANT
Exquisito	afilado	SYN
sótano	carrera	RANDOM
burla	burlas	SYN
porosidad	solidez	ANT
ambiguamente	sin ambigüedades	ANT
observar	lona	HYPER
hockey	apretón	RANDOM
comprar	alto	RANDOM
sonido metálico	choque	SYN
probable	improbable	ANT
duela	balancín	PART_OF
caña	calzado	PART_OF
gancho	penacho	SYN
pámpano	pámpano	PART_OF
padre	limpiar	RANDOM
gastos generales	desembolso	HYPER
escalera	edificio	PART_OF
intolerablemente	tolerablemente	ANT
masculino	enlazar	RANDOM
pico	espíritu	RANDOM
generalato	palanquilla	HYPER
bajo	ideología	RANDOM
alegría	Oeste	RANDOM
colmena	colmenar	PART_OF
además	además	SYN
teogonía	dominio	HYPER
pista	ferrocarril	PART_OF
deformidad	desfiguración	SYN
ayuda	caja	RANDOM
poder	incapaz	ANT
cubículo	convento	PART_OF
pelota	Menos	RANDOM
rareza	la falta de familiaridad	HYPER
electrodo	circuito	PART_OF
caliente	solución	RANDOM
patada	ganancia	HYPER
picar	infección	HYPER
quintal	t	PART_OF
presentación	almacenamiento	HYPER
calculador	perspicaz	SYN
accidente	profesor	RANDOM
moderno	familia	RANDOM
periscopio	submarino	PART_OF
intestino	torso	PART_OF
carro	torno	PART_OF
conveniencia	instrumentación	HYPER
inmovilidad	movilidad	ANT
apestar	oler	HYPER
comenzando	origen	SYN
anexo	edificio	PART_OF
gatito	cascada	RANDOM
saltar	espacio	RANDOM
marido	constante	HYPER
arado	unplowed	ANT
párpado	óptico	PART_OF
TI	arbusto	HYPER
cachorro	novato	SYN
ombligo	abdomen	PART_OF
endibia	endibia	PART_OF
microprocesador	microordenador	PART_OF
reajuste	alojamiento	HYPER
sacarina	edulcoración	HYPER
accesible	inaccesible	ANT
acelga	acelga	PART_OF
debilitante	vigorizante	ANT
Jiao	Kwai	PART_OF
fortuitamente	por suerte	SYN
alegría	temporada	RANDOM
instalar	rostro	HYPER
techumbre	edificio	PART_OF
cavar	agarrar	SYN
repetición	ocurrencia	HYPER
lote	pila	SYN
tinta	tela	RANDOM
durmiente	ferrocarril	PART_OF
aterrizaje	paseo marítimo	PART_OF
trozo de cuero	kilo	PART_OF
científico	no científico	ANT
empeine	media	PART_OF
remedio	intervención	PART_OF
perder	zapato	RANDOM
endocrino	exocrina	ANT
variedad	especies	PART_OF
el mayor	relativo	HYPER
acusado	demandante	ANT
convencional	poco convencional	ANT
nanosegundo	microsegundo	PART_OF
actor	escenario	RANDOM
come	nutritivo	HYPER
brazo	automóvil	PART_OF
dramático	undramatic	ANT
criminalización	despenalización	ANT
caja	sol	RANDOM
Japón	guay	RANDOM
esplendor	esplendor	SYN
ojos	sin ojos	ANT
humano	estar	RANDOM
7º	séptimo	SYN
rotor	trolebús	PART_OF
diente	hebilla	PART_OF
enmendar	remedio	SYN
tecnócrata	alguien	HYPER
tentáculo	excrecencia	HYPER
desnatar	pasar rozando el agua	SYN
entrepuente	navegación	PART_OF
banco	equipo	PART_OF
ombligo	torso	PART_OF
benéfico	pernicioso	ANT
dentado	sin dientes	ANT
orinal	lav	PART_OF
espalda	broncearse	RANDOM
salto	lavabo	RANDOM
ocupado	miembro	RANDOM
nación	vagón	RANDOM
excitable	irritable	SYN
marca	salvaje	RANDOM
reloj	joven	RANDOM
afluente	alimentador	SYN
niño	palabra	RANDOM
cortafuegos	actuación	HYPER
collar	policía	SYN
afectado	movido	SYN
grande	piedra	RANDOM
inhabilidad	falta de aptitud	HYPER
1000	tú	SYN
clase	amante	RANDOM
quintal	kilotones	PART_OF
ubicación	estudio	ANT
mediados de los sesenta	años	PART_OF
béisbol	sofbol	ANT
curioso	peculiar	SYN
heterosexual	espalda	RANDOM
clima	estado	HYPER
importar	hecho	RANDOM
visa	autorizar	HYPER
absolución	convicción	ANT
aguijón	mediación	HYPER
angelical	querúbico	SYN
insensible	sensible	ANT
balancín	cuna	PART_OF
papel	oír	RANDOM
buffer	locomotora	PART_OF
sincronización	reguladora	HYPER
cromosoma	núcleo	PART_OF
asesinato	paño	RANDOM
aumento	aumentar	HYPER
repelente	repelente	SYN
fragua	horno	HYPER
balaustrada	balcón	PART_OF
exterior	ligado	HYPER
tinta	rebotar	RANDOM
hasta ahora	hasta ahora	SYN
modesto	tamaño de bolsillo	SYN
puesta del sol	noche	PART_OF
arbitrar	intermedio	SYN
dl	l	PART_OF
camilla	edificio	PART_OF
inconmensurablemente	hasta cierto grado	ANT
bloquear	motora	PART_OF
ecuestre	viajero	HYPER
un cuarto de siglo	siglo	PART_OF
reentierro	enterrando	HYPER
retina	óptico	PART_OF
ocioso	perjudicar	RANDOM
lahar	diapositiva	HYPER
involuntario	voluntario	ANT
legumbre	legumbre	PART_OF
dramatizar	embellecer	SYN
compañero	pareja	PART_OF
aleta	auto	PART_OF
corsé	Fundación	HYPER
disentimiento	resistir	SYN
casa	detener	RANDOM
maximización	minimización	ANT
cañón	bombardeo	PART_OF
metafase	mitosis	PART_OF
chip	utilizar	RANDOM
seguir	difícil	SYN
malo	espíritu	RANDOM
listón	enrejado	PART_OF
júnior	mayor	ANT
molestia	provocar	SYN
rencor	resentimiento	SYN
ancho	amplio	SYN
quintal	kilotones	PART_OF
atmósfera	guerra	RANDOM
sentido	sentido	HYPER
mamífero	obtener	RANDOM
declinación	disminución	SYN
trotón	cerdo	PART_OF
impertinente	ortogonal	SYN
acción	nivel	RANDOM
transferir	transponer	SYN
ocular	prismáticos	PART_OF
lat	dorso	PART_OF
campanilla	campánula	HYPER
caja	correr	RANDOM
extensión	nombre del archivo	PART_OF
clasificación	desclasificación	ANT
retribuido	pago	SYN
disponibilidad	indisponibilidad	ANT
Alto	de poca altura	ANT
cilantro	cilantro	PART_OF
esotérico	exotérico	ANT
látigo	peor	SYN
exclamar	expresar verbalmente	HYPER
hamburguesa	hamburguesa	PART_OF
pedernal	obstinado	SYN
delineado	representado	SYN
jeremiada	objeción	HYPER
joven	alguien	HYPER
canabis	sexo	RANDOM
funcional	no funcional	ANT
aterrizaje	refugio	PART_OF
atraco	robo	HYPER
acelerar	despertar	HYPER
rallar	rejilla	SYN
cerebro	isla	RANDOM
manzana	esposa	RANDOM
contender	concurso	SYN
conferencia	curso	PART_OF
Cuarto	número	RANDOM
intestino	abdomen	PART_OF
molestia	sacar de quicio	HYPER
reparar	reparación	SYN
Glazer	vidriero	SYN
dirigible	aeronave	HYPER
dique	lesbiana	HYPER
citocinesis	proceso	HYPER
marca	sala	RANDOM
Tiffin	nutrición	HYPER
anillo	decoración	HYPER
media	Error	RANDOM
amalgamar	fusionado	SYN
indefenso	incapacitado	SYN
sección en medio	región	HYPER
ola	inflar	SYN
chapucear	pelusa	SYN
generosidad	tacañería	ANT
azul	tren	RANDOM
cuantitativo	silábico	ANT
coautor	autor	HYPER
irrelevante	pertinente	ANT
dama	ideología	RANDOM
hardware	software	ANT
recuperar	recuperar	SYN
acuerdo	guay	RANDOM
bloquear	patrón	RANDOM
cráneo	caput	PART_OF
conservador	liberal	ANT
timón	tirón	PART_OF
Irlanda	drama	RANDOM
corcel	caballo de guerra	HYPER
caliente	héroe	RANDOM
eco	recordar	SYN
ruptura	lesión	HYPER
construir	acreción	HYPER
rechazo	ofensa	HYPER
eco	reverberar	SYN
continuar	preservar	SYN
asustado	sin miedo	ANT
abatimiento	heces	SYN
gobierno	navegación	PART_OF
masas	multitud	SYN
pomo	empuñadura	PART_OF
cuidado	palabra	RANDOM
aguacate	aguacate	PART_OF
mapa	temporada	RANDOM
derivación	circuito	PART_OF
criptoanálisis	criptología	SYN
insustituible	reemplazable	ANT
inspiración	respiración	PART_OF
selección	salpicón	HYPER
teta	mamá	PART_OF
tarde	anterior	SYN
oferta	giro	SYN
ilustrado	no iluminada	ANT
movimiento	desagradable	RANDOM
pulmón	estado animico	RANDOM
sillín	dorso	PART_OF
ingreso	eclipse	PART_OF
botánico	botánico	SYN
avo	pataca	PART_OF
cómoda	domicilio	PART_OF
novio	seco	RANDOM
pedernal	de pedernal	SYN
cabezal	motora	PART_OF
cuenta	residencia	RANDOM
bautizado	no bautizados	ANT
bisagra	auto	PART_OF
silenciador	escape	PART_OF
coco	palma de coco	PART_OF
hervir	destruir	RANDOM
sembrador	creador	HYPER
pálido	cerca	RANDOM
especioso	espurio	SYN
China	vestir	RANDOM
marrón	marron oscuro	SYN
conocible	desconocido	ANT
lineal	planar	ANT
pez real	caballa	HYPER
escritura	comprensión	HYPER
microgramo	miligramo	PART_OF
perezoso	comité	RANDOM
oxaloacetato	compuesto	HYPER
lychee	lychee	PART_OF
naranja	residencia	RANDOM
justa	falta	ANT
deseo	deseo	HYPER
paisa	taka	PART_OF
habitable	inhabitable	ANT
eficazmente	ineficazmente	ANT
noche	sucio	RANDOM
asper	kurus	PART_OF
apresador	libertador	ANT
palpitar	temblar	HYPER
Nota	cueva	RANDOM
piedra clave	acueducto	PART_OF
espada	Luna	RANDOM
inexorable	implacable	SYN
brillante	mates	RANDOM
culo	sinvergüenza	SYN
apéndice	ciego	PART_OF
intransitivo	transitivo	ANT
gunstock	pistola	PART_OF
refundir a	diputar	HYPER
brillante	paquete	RANDOM
clero	laicado	ANT
falange	vertebrado	PART_OF
admirar	ruido	RANDOM
sin hogar	pobre	HYPER
hacer	sala	RANDOM
atípicamente	típicamente	ANT
antena	receptor	PART_OF
designacion	encontrar	HYPER
muelle	refugio	PART_OF
inmortalidad	mortalidad	ANT
cutícula	molusco	PART_OF
devenir	bueno	SYN
irrelevancia	pertinencia	ANT
comprometido	no comprometido	ANT
cuenco	bochas	PART_OF
chirriador	unidad	HYPER
pinchazo	puñalada	SYN
borradura	labor	PART_OF
decreto	fíat	SYN
internacionalismo	nacionalismo	ANT
ácido	virulento	SYN
tierra	ley	RANDOM
suegro	relativo	HYPER
vigorizante	marco de referencia	PART_OF
mantequilla	tráfico	RANDOM
interludio	intermezzo	SYN
hueso	Servicio	RANDOM
agujero	tráfico	RANDOM
helicóptero	cuchilla de carnicero	SYN
armario	basura	RANDOM
admisible	inadmisible	ANT
Thane	noble	HYPER
descendencia	dejar	RANDOM
equilibrar	equilibrio	SYN
ayuda	arbusto	RANDOM
derriere	torso	PART_OF
aumentador de presión	infraestructura	PART_OF
deshonra	honor	ANT
circunvolución	cerebro	PART_OF
lírica	vocal	PART_OF
sangre	escapar	RANDOM
reclutador	proveedor	HYPER
revisado	sin control	ANT
amor	ídolo	RANDOM
inclinación	apoyarse	SYN
exacto	inexacto	ANT
extremadamente	crónicamente	ANT
decenas	montones	SYN
imperfectamente	perfectamente	ANT
intercalación	calendario	PART_OF
fanfarrón	canto	SYN
cariño	sensación	HYPER
gatito	comercio	RANDOM
crédito	Foto	PART_OF
impiedad	piedad	ANT
vidrioso	vítreo	SYN
importar	impartir	HYPER
prontamente	pronto	SYN
terrible	indecible	SYN
bofetada	prenda	PART_OF
tipo	gobierno	RANDOM
perdedor	ganador	ANT
Engánchate	sistema	HYPER
libidinoso	libidinoso	SYN
descendencia	galaxia	RANDOM
instalaciones	preparación	SYN
sabiendas	sin saberlo	ANT
himen	vagina	PART_OF
rayo de sol	rayo	HYPER
pecho	poulet	PART_OF
Leche	casco	RANDOM
demencia	locura	HYPER
preocupado	despreocupado	ANT
hurto	ladrón	SYN
animal	dedo del pie	RANDOM
hermano	hermana	ANT
maxi	mini	ANT
delantal	aeródromo	PART_OF
impermeable	artefacto	HYPER
ráfaga	remover	SYN
burlesco	imitar	HYPER
evocar	sugerir	SYN
nanotecnología	campo	HYPER
escrúpulo	contemplar	HYPER
parche	paquete	HYPER
casquete	cráneo	PART_OF
Actriz	tarro	RANDOM
katzenjammer	estado	HYPER
olvidable	inolvidable	ANT
almohadilla	sudar tinta	SYN
involuntariamente	voluntariamente	ANT
soplar	frase	RANDOM
pacer	capa	HYPER
pardo	adular	SYN
libra	quintal	PART_OF
capucha	automóvil	PART_OF
camino	infraestructura	PART_OF
herbívoro	omnívoro	ANT
ganado	no ganado	ANT
masculino	portón	RANDOM
añadir	tela	RANDOM
carne de vaca	demanda	RANDOM
as	súper	SYN
pene	pagano	RANDOM
degradar	nombrar	HYPER
accesibilidad	inaccesibilidad	ANT
cresta	blasón	PART_OF
palma	manus	PART_OF
ligado	staccato	ANT
mercado	cordón	RANDOM
caput	criatura	PART_OF
apropiado	inapropiado	ANT
muda	cobertizo	SYN
violín	modificar	HYPER
intercambio	transacción	HYPER
santidad	agrupamiento	HYPER
impresión	accesibilidad	HYPER
cuenta	fin	RANDOM
ladrar	casar	RANDOM
cajón	vestidor	PART_OF
tenor	músico	HYPER
metro	presa	PART_OF
verdulero	comerciante	HYPER
enfocado	desenfocado	ANT
impaciencia	paciencia	ANT
caña	carretilla	PART_OF
Tapper	alguien	HYPER
cuenco	ir	HYPER
prestar	alterar	HYPER
orinal	poder	PART_OF
barbilla	homo	PART_OF
de colores	Unilateral	SYN
homogéneo	homogénea	SYN
bañera	vivienda	PART_OF
mercado	salida	HYPER
clasicista	romántico	ANT
hoja	solución	RANDOM
intestino	torso	PART_OF
suplicante	imperativo	ANT
decilitro	l	PART_OF
horrible	aterrador	SYN
camino	tránsito	PART_OF
total	modificar	HYPER
Jack	yaca	PART_OF
dirigido	sin tratar	ANT
collar azul	de cuello blanco	ANT
Correa	liga	PART_OF
mi	grafema	HYPER
barco de cañón	motos acuáticas	HYPER
terraplén	montículo	HYPER
cura	intervención	PART_OF
aficionado	atleta	HYPER
abogado	predicar	SYN
Noticias	vestíbulo	RANDOM
trígono	trilátero	SYN
rizo	peinado	PART_OF
montaña	fiesta	RANDOM
central eléctrica	infraestructura	PART_OF
turborreactor	turborreactor	PART_OF
pinchazo	gesto	HYPER
línea	integridad	RANDOM
equilibrar	desequilibrio	ANT
nectarina	nectarina	PART_OF
matrimonio	contar	RANDOM
suelto	Asia	RANDOM
mantequilla	dama	RANDOM
a mitad de camino	carnaval	PART_OF
El Intercambio	cretino	SYN
cáncer	ligero	RANDOM
recibir	percibir	HYPER
atleta	cargar	RANDOM
primavera	prímula	SYN
preferencia	activo	HYPER
insolvente	solvente	ANT
pez globo	fumador	PART_OF
sumergir	escarpado	SYN
corola	florecer	PART_OF
cuello	artefacto	HYPER
artesano	artesano	SYN
decimosexto	posición	HYPER
alojamiento	artefacto	HYPER
hipnosis	condición	HYPER
inalienable	inalienable	SYN
desertor	cobarde	HYPER
hacer	vuelo	RANDOM
orégano	Mejorana	PART_OF
anuncio	asociar	HYPER
sórdido	miserable	SYN
capítulo	terminar	RANDOM
capacidad	incapacidad	ANT
adherirse	colgar	SYN
viraje	tendencia	SYN
reconocer	admitir	SYN
gancho	trampa	SYN
pel	raster	PART_OF
de abajo hacia arriba	De arriba hacia abajo	ANT
cilindro	compresor	PART_OF
propicio	poco propicio	ANT
demente	perturbado	SYN
mear	orinar	SYN
camisa de entrenamiento	sudores	PART_OF
sobre	globo	PART_OF
palabras	diálogo	PART_OF
parte	ganancias	PART_OF
dentro del cuadro	jardines	ANT
esperma	eyacular	PART_OF
nación	inmundo	RANDOM
cadena	ingrediente	RANDOM
prodding	estimular	SYN
sensible	insensible	ANT
pedo	pedos	SYN
tercero	automóvil	PART_OF
calma	pescado	RANDOM
núcleo	biblioteca	RANDOM
comunicable	transmisible	SYN
monstruo	anomalía	HYPER
yacimiento petrolífero	campo	HYPER
cuenta	máquina	RANDOM
perca	milla	PART_OF
reacio	complaciente	ANT
radio	brazo	PART_OF
imitación	interpretación	SYN
capítulo	regla	RANDOM
absurdo	rasgo	HYPER
constitucionalmente	inconstitucionalmente	ANT
canturrear	pronunciar	HYPER
criminalización	despenalización	ANT
fontanela	menor	PART_OF
captura	hacer	RANDOM
sicario	torpedo	SYN
Fundación	estructura	PART_OF
concéntrico	excéntrico	ANT
apariencia	desaparición	ANT
escotilla	pasar rozando el agua	SYN
angustioso	preocupante	SYN
blooper	torpeza	SYN
sospechar	imagina	HYPER
amortiguando	cansado	SYN
enlazar	disco	RANDOM
objeto	creación	RANDOM
profesión	confesión	HYPER
conocimiento	dinero	RANDOM
humano	Produce	RANDOM
homosexual	alabanza	RANDOM
borde	varita mágica	SYN
colectivismo	orientación	HYPER
incapacitante	permitiendo	ANT
nadir	firmamento	PART_OF
fotomontaje	icono	HYPER
barandilla	pretil	PART_OF
fontanela	pajarito en el nido	PART_OF
Cubierta	comida	PART_OF
cardamomo	cardamomo	PART_OF
bombardear	golpe	HYPER
capucha	auto	PART_OF
egoísta	altruista	ANT
Misisipí	lucha	RANDOM
sucio	triste	SYN
mecha	vela	PART_OF
enfermedad	correcto	RANDOM
gonzo	extravagante	SYN
forte	acero	PART_OF
preceder	ingerir	HYPER
en general	estrechamente	ANT
mandíbula	OS	HYPER
talento	aptitud	HYPER
clorato	sal	HYPER
fémur	muslo	PART_OF
alba	túnica	HYPER
atención	desatento inatención	ANT
predominante	abundante	SYN
sin sentido	romance	HYPER
imprudencia	prudencia	ANT
maldad	bondad	ANT
solicitud	actividad	HYPER
ruidoso	capa	RANDOM
apoteosis	ideal	SYN
matrimonio	art	RANDOM
cintura	cabeza del palo	PART_OF
minero	obrero	HYPER
creíble	increíblemente	ANT
brillante	cortar con tijeras	RANDOM
somnolencia	desvelo	ANT
clase	entender mal	RANDOM
anillo	falda	SYN
cenefa	alfombra	PART_OF
Mediano plazo	gestación	PART_OF
mezcla	energía	RANDOM
parteluz	edificio	PART_OF
facilitador	ayudante	HYPER
falange	dáctilo	PART_OF
lista	relación	HYPER
perturbar	afectar	HYPER
gladiolo	esternón	PART_OF
perrera	dependencia	HYPER
perseguir	ortiga	HYPER
oferta	salario	HYPER
desajuste	equivalente	HYPER
surtido	clasificación	SYN
distal	proximal	ANT
antepasado	descendiente	ANT
beneficiario	receptor	HYPER
cadena	lado	RANDOM
anticolinérgico	colinérgica	ANT
puesta del sol	recordar	PART_OF
acampar	abrigo	HYPER
guisante	vegetal	HYPER
ocular	monumentos	PART_OF
papel	agujero	RANDOM
Adolescente	joven	SYN
explosión	expresión	HYPER
auténtico	literal	SYN
atado	desatado	ANT
no	sí	ANT
portador	portador del féretro	SYN
transición	modificación	HYPER
máquina	cuerno	RANDOM
remilgado	repipi	SYN
dicción	fraseo	SYN
oportunidad	inadecuación	ANT
engañar	mimar	SYN
eje	edificio	PART_OF
desmérito	mérito	ANT
golpeteo	palpitar	SYN
astillas	iluminación	SYN
despido	saco	SYN
faringe	cuello	PART_OF
hito	ocurrencia	HYPER
tablero de damas	borradores	PART_OF
sector	campo	PART_OF
entrometido	entrometido	HYPER
bailarín	siendo	HYPER
pene	maceta	RANDOM
minimizar	subestimar	SYN
escápula	hombro	PART_OF
capitán	mojado	RANDOM
rallar	horno	PART_OF
ahogar	humo	HYPER
sin estrellas	estrellado	ANT
testículo	testículo	SYN
compañero	instrumento	RANDOM
acto	vehículo	RANDOM
béisbol	cabeza	RANDOM
jota	apunte	SYN
alto	cero	RANDOM
pavimentado	sin pavimentar	ANT
BASIC	introductorio	SYN
adaptado	maladaptativa	ANT
inestabilidad	estabilidad	ANT
prohibición	desterrar	SYN
cebollino	cebollín	PART_OF
saboreando	consumo	HYPER
pronóstico	perspectiva	SYN
tipo	canción	RANDOM
baloncesto	mascota	RANDOM
audaz	intrépido	SYN
buffet	nutrición	HYPER
amable	adorable	SYN
distracción	diversión	HYPER
burgués	ciudadano	SYN
azul	alguna cosa	RANDOM
envío	expedición	SYN
ídem	iterar	HYPER
apaciguar	permanecer	SYN
deseable	indeseable	ANT
igualdad	desigualdad	ANT
párrafo	publicación	PART_OF
exón	intrón	ANT
desencadenar	mediación	HYPER
convocar	despojo	PART_OF
párpado	óculo	PART_OF
sórdido	miserable	SYN
monótona	monótono	SYN
veleta	helicóptero	PART_OF
cuenta	completo	RANDOM
devenir	decoroso	SYN
viniendo	sincronización	HYPER
gaseado	cargado	SYN
inferior	comunicación	RANDOM
sección	pelotón	PART_OF
comenzando	finalizando	ANT
deshidratado	seco	SYN
vale	admirador	HYPER
turboventilador	chorro	HYPER
tronco	pigmento	HYPER
empuñadura	pegatina	PART_OF
dirham	dinar	PART_OF
compañero	sombrero	RANDOM
camiseta	útero	PART_OF
perder	granja	RANDOM
partidista	aumentador de presión	HYPER
servidumbre	esclavo	HYPER
marabú	morabito	PART_OF
triste	jubiloso	ANT
amor	individual	RANDOM
metálico	no-metalico	ANT
válvula	latón	PART_OF
menguante	depilación	ANT
resaca	corriente	HYPER
calle de rodaje	tránsito	PART_OF
cañón	cuadrúpedo	PART_OF
hablador	gárrulo	SYN
camino	unidad	HYPER
muesca	distancia	PART_OF
equilibrar	hecho	RANDOM
afirmativo	negativo	ANT
desmadejado	disperso	SYN
probabilidad	improbabilidad	ANT
avión	teoría	RANDOM
energizar	excitar	SYN
almiar	cúmulo	HYPER
exigencia	pellizco	SYN
trono	lav	PART_OF
arco	desagradable	RANDOM
brillo	lo aburrido	ANT
decididamente	incuestionablemente	SYN
céntimo	dinar	PART_OF
pequeño	demanda	RANDOM
meditativo	pensativo	SYN
cama	hacha	RANDOM
abdomen	estómago	PART_OF
interferencia	no interferencia	ANT
encanto	sabor	HYPER
mencionar	referencia	SYN
armario	enseñar	RANDOM
negro	día	RANDOM
habitante	siendo	HYPER
perdió	won	ANT
grande	el maletero	RANDOM
pantalones cortos	bragas	SYN
legal	legítimo	SYN
moderación	templanza	SYN
perder	común	RANDOM
diapasón	banjo	PART_OF
la muda	muda	SYN
art	caminar	RANDOM
inocular	modificar	HYPER
cortador	alimentador	HYPER
ejecutar	matar	HYPER
barba	bigotes	SYN
mésico	xérica	ANT
freír	pajarito en el nido	SYN
mercurio	estudiante	RANDOM
irritante	vejatorio	SYN
jorobado	curcuncho	SYN
cadena	matrimonio	RANDOM
camino acuático	artefacto	HYPER
doblez	recinto	HYPER
recuperación	reforma	SYN
estambre	angiosperma	PART_OF
bajura	costa afuera	ANT
refugio subterráneo	estadio de béisbol	PART_OF
cifrar	cero	SYN
arma nuclear	atacar	HYPER
tina	habitación	PART_OF
hermosa	grabar	RANDOM
moribundo	toda la vida	PART_OF
idioma	sello	RANDOM
objetivo	subjetivo	ANT
remisión	penitencia	PART_OF
de dos sexos	monoica	ANT
irreverencia	reverencia	ANT
mariscos	molusco	PART_OF
contentamiento	descontento	ANT
humildad	ocupado	RANDOM
ignorancia	marco	RANDOM
teogonía	campo	HYPER
intromisión	oficioso	SYN
vestíbulo	tomar	RANDOM
secreto	rasgo	HYPER
flexibilidad	inflexibilidad	ANT
premeditación	provisión	HYPER
Ojalá	sin esperanza	ANT
descortés	Cortés	ANT
yo	ruido	RANDOM
fundado	sin fondos	ANT
propaganda	aprobación	SYN
chico	Oceano	RANDOM
matrimonio	llegar	RANDOM
acto	nieve	RANDOM
voluble	azogue	SYN
aguijón	acosar	HYPER
porosidad	solidez	ANT
abatido	exaltado	ANT
preparación	resolución	ANT
sacristía	Iglesia	PART_OF
locador	topógrafo	HYPER
finitamente	infinitamente	ANT
Introducción	recital	PART_OF
litro	hl	PART_OF
billar	billar	PART_OF
adulto	noche	RANDOM
aguas revueltas	marea	PART_OF
impugnada	incontestado	ANT
aleta	automóvil	PART_OF
cangrejo de río	cangrejo de río	PART_OF
dolores del parto	gestación	PART_OF
conductor	programa	HYPER
canal	activo	RANDOM
inmoderado	moderar	ANT
acantilado	drop-off	SYN
pegajoso	pastoso	SYN
línea de sangre	descendencia	SYN
mercurio	tener	RANDOM
regañarse	reprensión	SYN
invertir	grado	HYPER
mejorado	sin mejorar	ANT
contorno	delinear	HYPER
motivo	tema	SYN
santo	impío	ANT
película	diccionario	RANDOM
desdeñoso	orgulloso	SYN
árbitro	autoridad	HYPER
rallar	distancia	PART_OF
estorbador	obstructivo	SYN
consumo	respiración	PART_OF
intestino ciego	ciego	SYN
ilegal	proscrito	SYN
bacalao	vaina	SYN
corona	nimbo	PART_OF
relamerse	regodeo	SYN
armar	fuerte	RANDOM
nadir	Cielos	PART_OF
codorniz	codorniz	PART_OF
afeitado	limpiar	HYPER
yugular	cerviz	PART_OF
disforia	descontento	HYPER
pinger	submarino	PART_OF
berberecho	volante fruncido	SYN
caso	fallar	RANDOM
aire	broncearse	RANDOM
empezar	correcto	RANDOM
crepúsculo	anochecer	SYN
soporte	ordenar	HYPER
tarso	vertebrado	PART_OF
Oceano	cerca	RANDOM
garra	luchar	PART_OF
mentira	lavabo	RANDOM
reumatismo	enfermedad	HYPER
rápido	camino acuático	HYPER
existencia	no existencia	ANT
hielo	enjuiciamiento	RANDOM
alegre	bastante	SYN
patio de butacas	teatro	PART_OF
preceder	premisa	SYN
Cereza	Cereza	PART_OF
rizar	flexura	SYN
línea	ventana	RANDOM
porta	avión	PART_OF
reacquaint	familiarizar	HYPER
acosado	acosado	SYN
latido del corazón	ocurrencia	HYPER
alcantarilla	infraestructura	PART_OF
defecto	suspender	SYN
reprimir	dominar	HYPER
aire	recompensa	RANDOM
subtítulo	película	PART_OF
poco	lápiz	RANDOM
pastilla	pastilla	PART_OF
limpiar	chimenea	RANDOM
santuario	rodear	HYPER
fijador	compuesto	HYPER
modelo	simular	HYPER
disgustado	satisfecho	ANT
paisajismo	jardinería	HYPER
salsa de tomate	condimento	HYPER
aclimatarse	aclimatarse	SYN
codicioso	prensil	SYN
cabestro	horca	PART_OF
frenéticamente	locamente	SYN
canal	Turquía	RANDOM
purificar	sublimado	SYN
aritmética	derecho	RANDOM
bombardeo aéreo	ataque	HYPER
bárbaro	incivilizado	SYN
adherente	discípulo	SYN
hermosa	Perfecto	RANDOM
brillante	apartamento	RANDOM
doloroso	sin dolor	ANT
irritar	ortiga	SYN
gatear	carrera	HYPER
bipolar	unipolar	ANT
imperceptible	perceptible	ANT
hielo	relajarse	RANDOM
transportador	fábrica	PART_OF
densamente	finamente	ANT
boca	tomar	RANDOM
enfado	teclado	RANDOM
ahogo	humedecer	HYPER
bañera	morada	PART_OF
pata delantera	cuadrúpedo	PART_OF
pediatra	médico	HYPER
chocolate	martillo	RANDOM
vestida	desvestido	ANT
marquesina	pabellón	HYPER
beneficio	templo	RANDOM
preparación	resolución	ANT
eflujo	afluencia	ANT
cadencia	metro	SYN
inconstancia	infidelidad	HYPER
miembro	paraguas	RANDOM
referir	asociar	HYPER
armar	pálido	RANDOM
cadena	recoger	RANDOM
litro	dal	PART_OF
pandeo	discapacidad	HYPER
chico	dirigir	RANDOM
espejismo	truco	SYN
parquet	teatro	PART_OF
honor	considerar	HYPER
distopía	utopía	ANT
anfitriona	patrón	HYPER
compuerta	regulador	HYPER
downmarket	lujo	ANT
moribundo	toda la vida	PART_OF
umbilical	embrión	PART_OF
mantequilla	calidad	RANDOM
supremo	preponderante	SYN
mezzo	mezzosoprano	SYN
alicaído	severo	SYN
esguince	trauma	HYPER
negro	blanco	ANT
revalorización	clasificación	HYPER
tinta	apuntalar	RANDOM
Mercer	comerciante	HYPER
antifonario	sensible	SYN
tapa	todo	RANDOM
período	Eón	PART_OF
inferior	ley	RANDOM
reequipar	proporcionar	HYPER
articulado	por contrato	SYN
producto	salida	PART_OF
hacer	corto	RANDOM
demolición	destrucción	SYN
formación	actividad	HYPER
culto	moda	SYN
degradado	desenfrenado	SYN
ostentoso	ruidoso	SYN
espalda	alto	RANDOM
aplausos	gritos	SYN
mediados de los ochenta	vejez	PART_OF
a favor del aborto	Pro vida	ANT
Irlanda	escribir	RANDOM
mesón	Filete de ternera	HYPER
cómoda	lav	PART_OF
escritorio	monasterio	PART_OF
irrevocable	revocable	ANT
confinamiento	el embarazo	PART_OF
civil	incivil	ANT
burlesco	satirizar	SYN
Espinacas	Espinacas	PART_OF
ácido	alcalino	ANT
mente	maíz	RANDOM
ácido	compuesto	HYPER
especializarse	variar	HYPER
inspiración	ventilación	PART_OF
pastor	pastor	SYN
oficial	marinero	HYPER
ascender	entender	RANDOM
mancha	racha	SYN
arco	acueducto	PART_OF
importar	el maletero	RANDOM
arco	arcada	PART_OF
amistoso	hostil	ANT
ordenado	desordenado	ANT
sexismo	favoritismo	HYPER
loco	chiflado	SYN
mil	cl	PART_OF
antiséptico	séptico	ANT
planificado	no planificado	ANT
notado	inadvertido	ANT
estúpido	necio	SYN
ingle	rompeolas	SYN
en buen estado para navegar	en condiciones de navegar	ANT
normal	paranormal	ANT
falta del tiempo	el tiempo de actividad	ANT
falta	repugnante	SYN
inconmensurable	inestimable	SYN
alegre	azotaina	SYN
toma de posesión	sustancia	HYPER
insensibilidad	sensibilidad	ANT
identificable	inidentificable	ANT
coba	víveres	HYPER
quilla	cáscara	PART_OF
delicadeza	discernimiento	HYPER
afilar	vela	PART_OF
droga	info	HYPER
dextral	sinistral	ANT
obediente	desafiante	ANT
saltar	naturaleza	RANDOM
recrear	energizar	HYPER
lapso	infraestructura	PART_OF
frágil	robusto	ANT
manejable	inmanejable	ANT
negro	blanco	ANT
vacío	plenitud	ANT
dormitorio	domicilio	PART_OF
evocar	extraer	SYN
granuja	perro de calle	HYPER
índice	squash	RANDOM
calibre	adivinar	SYN
mapa	cultivo	RANDOM
prenatal	prenatal	SYN
desalinización	desalinización	SYN
limpiabotas	moretón	HYPER
sin semillas	sórdido	ANT
compatibilidad	incompatibilidad	ANT
pisada	paso	SYN
paginación	declaración	HYPER
tráquea	cuello	PART_OF
hierro	hostilidad	RANDOM
mendigo	mendicante	SYN
navegar	ir	HYPER
socavón	mina de carbón	PART_OF
individual	tenis	HYPER
obstruir	falta	SYN
cuenta	pantalones	RANDOM
cordón	tren	RANDOM
abuso	vilipendio	SYN
ombligo	vientre	PART_OF
consumo	respiración	PART_OF
paintball	cápsula	HYPER
colectivista	Controlado por el estado	SYN
tocón	mistificar	HYPER
acuerdo	estatua	RANDOM
comienzo	comienzo	SYN
movido	impasible	ANT
forzada	no ejecutadas	ANT
cúrcuma	cúrcuma	PART_OF
crup	cuadrúpedo	PART_OF
salón	habitación	PART_OF
calma	inútil	RANDOM
corregido	sin corregir	ANT
enumerado	no estante en la lista	ANT
preguntador	altavoz	HYPER
masculino	articulación	RANDOM
instrumental	vocal	ANT
perceptible	imperceptible	ANT
empeine	pes	PART_OF
detrás	bollos	SYN
portero	portero	SYN
suelto	ocioso	RANDOM
conspicuamente	discretamente	ANT
medio litro	cuarto de galón	PART_OF
dueño de casa	cabeza de familia	SYN
convincentemente	poco convincente	ANT
compañero	dos	PART_OF
atmósfera	matrimonio	RANDOM
eflujo	afluencia	ANT
venturi	carburador	PART_OF
desánimo	ánimo	ANT
imagen	conclusión	RANDOM
privación	rigor	SYN
procesador	preocupación	RANDOM
cableada	inalámbrico	ANT
Cada vez más	Siempre	SYN
rechazar	rechazo	HYPER
ingenuidad	sofisticación	ANT
salmón	salmón	PART_OF
exudado	excretar	HYPER
béisbol	sofbol	ANT
baboso	indigno de	SYN
idioma	tema	RANDOM
no proliferación	proliferación	ANT
ayuda	cubo	RANDOM
listón	maderas	HYPER
cóncavo	convexo	ANT
música	antiguo	RANDOM
alto	auto	PART_OF
hardware	software	ANT
aire-superficie	superficie-a-aire	ANT
albañilería	edificio	PART_OF
casa	caucho	RANDOM
magnolia	magnolia	PART_OF
eucariota	procariota	ANT
crucero	viaje	HYPER
semana	semana de trabajo	SYN
recortado	sin recortar	ANT
término análogo	digital	ANT
dolor	lluvia	RANDOM
elegante	agraciado	SYN
hielo	Iniciar sesión	RANDOM
chaqueta	paisaje	RANDOM
predecir	presagiar	SYN
profano	sagrado	ANT
ímpetu	impulso	SYN
matricularse	registro	HYPER
vestíbulo	adjuntar	RANDOM
anal	oral	ANT
dos	Dickens	SYN
sótano	aburrido	RANDOM
paz	cristal	RANDOM
vago	vago	SYN
disforia	euforia	ANT
accidente	héroe	RANDOM
mareado	inquieto	SYN
coro	vocal	PART_OF
engañar	rebotar	RANDOM
cargado	descargada	ANT
belleza	sombrero	RANDOM
micrón	centímetro	PART_OF
tumba	esculpir	SYN
tubo	paso	HYPER
popurrí	variedad	SYN
parte	pasaje	RANDOM
fuga	viaje	RANDOM
dm	metro	PART_OF
negro	cocina	RANDOM
innato	natural	SYN
entrante	saliente	ANT
recuperar	ha podido recuperar	HYPER
casquete	caja del cráneo	PART_OF
cuna	siete y medio	PART_OF
Sonic	supersónico	ANT
tambalear	poner	HYPER
techo	descanso	RANDOM
miembro	parte	HYPER
vergonzoso	vergonzoso	SYN
caramelo	dedo del pie	RANDOM
naturalmente	no natural	ANT
anfibio	acuático	ANT
enunciar	vocalizar	SYN
fosfato	bebida	HYPER
convencional	nuclear	ANT
bestia	agresor	HYPER
factor	cromosoma	PART_OF
útil	inservible	ANT
centímetro	dm	PART_OF
fabricar	lobo	RANDOM
salir	desperdicios	RANDOM
80	ochenta	SYN
sala de redacción	oficina	HYPER
jerarquía	administración	PART_OF
digno	poco digna	ANT
pájaro cantor	cantante	SYN
Taoiseach	primer ministro	HYPER
pico	flecha	PART_OF
reparación	redención	HYPER
lío	mucho	SYN
empleado	desempleados	ANT
hipotálamo	prosencéfalo	PART_OF
creencia	tener	RANDOM
medio	calcetín	RANDOM
semental	edificio	PART_OF
fontanela	maquinilla de afeitar	PART_OF
de marcha en vacío	escritura	HYPER
poco	rascacielos	RANDOM
faja	faja	SYN
arrestar	collar	SYN
debilucho	camisa	PART_OF
babosa	cartucho	PART_OF
pegado	pegado	SYN
avanzar	poema	RANDOM
boyero	pastor	SYN
rana	ornamentación	HYPER
cuenta	amistoso	RANDOM
medicina	terminar	RANDOM
mcg	mg	PART_OF
libro	raro	RANDOM
Mañana	alegría	RANDOM
miseria	homosexual	RANDOM
guardaespaldas	séquito	PART_OF
miserable	miserable	SYN
engomado	masticación	HYPER
asombro	dejar perplejo	SYN
reconstruido	unreconstructed	ANT
conveniencia	inconveniencia	ANT
Correa	abrazadera	PART_OF
golpear	fijar	RANDOM
garbanzo	garbanzo	PART_OF
lápida sepulcral	tumba	PART_OF
mezcla	niño	RANDOM
pródigo	libertino	SYN
arqueológico	arqueológico	SYN
oquedad	solidez	ANT
acceder a	aplazar	SYN
cambiable	inmutable	ANT
percha	alguien	HYPER
hermoso	respetable	SYN
anteojera	intermitente	SYN
canal	estructura	HYPER
tipificar	tipificar	SYN
cuartos traseros	keister	SYN
activación	desactivación	ANT
toscamente	finamente	ANT
inscribir	promesa	HYPER
asimetría	simetría	ANT
caribú	reno	SYN
deshecho	mopes	SYN
adjetivo	adjetivo	PART_OF
subíndice	sobrescrito	ANT
dentro del cuadro	jardines	ANT
albañil	oficial	HYPER
abajo	piso de arriba	ANT
necesariamente	innecesariamente	ANT
transeúnte	porque	HYPER
entrega	parto	PART_OF
pago	asalariado	SYN
proporcionar	transferir	HYPER
descalzo	sin zapatos	SYN
parabrisas	lancha fuera borda	PART_OF
excluir	evitar	SYN
encubierto	abierto	ANT
pescado de roca	pescado de roca	PART_OF
integrar	figura	HYPER
altruista	egoísta	ANT
alinear	burla	HYPER
cartucho	fonógrafo	PART_OF
precepto	ética	PART_OF
estructurado	estructurado	ANT
bicameral	unicameral	ANT
curva	parque	RANDOM
cartera	bolso	SYN
menor cantidad	más	ANT
capuchino	Java	HYPER
hacia atrás	hacia atrás	SYN
cinturón verde	Camino verde	SYN
batidor	mezclador	HYPER
curación	plastinación	PART_OF
monitor	álbum	RANDOM
inoperante	operatorio	ANT
interior	exterior	ANT
espumoso	espumoso	SYN
acomodar	ajuste	SYN
médico	quirúrgico	ANT
circular	redondo	SYN
tubo respirador	sub	PART_OF
enchavetado	sin claves	ANT
sinápsido	reptil	HYPER
gelatina	nutrición	HYPER
tranquilidad	disposición	HYPER
rapé	pabilo	PART_OF
gaje	mejor	HYPER
soja	soja	PART_OF
distancia	alcance	SYN
insano	cuerdo	ANT
angustia	desamor	SYN
ascenso	descendencia	ANT
salsa	comida	PART_OF
meter	perforar	HYPER
béisbol	molécula	RANDOM
invadir	infringir	SYN
engomado	masculleo	SYN
sabroso	sabroso	SYN
De hierro fundido	hierro	SYN
tomatillo	tomatillo	PART_OF
falta de pago	mercantilismo	HYPER
sura	caña	PART_OF
Nada	nulo	SYN
palo de golf	bribón	HYPER
penetración	coito	HYPER
caja	lento	RANDOM
talón	cosa	HYPER
máscara	artefacto	HYPER
golosina	tratar	HYPER
acortar	salud	RANDOM
bocinazo	vómito	SYN
llevar	viento	RANDOM
ergio	unidad	HYPER
golpear	estado	RANDOM
susto	susto	SYN
altruismo	egoísmo	ANT
pimienta	Condimento	HYPER
compatible	incompatible	ANT
inestabilidad	estabilidad	ANT
coda	opus	PART_OF
vitamina	nutritivo	HYPER
equitación	atletismo	HYPER
grieta	brecha	SYN
tornillo	tú	RANDOM
asesinato	continente	RANDOM
quilate	gramo	PART_OF
observador	siendo	HYPER
carril	denunciar	HYPER
exponer	peligro	SYN
consejo	discutir	HYPER
responder	oveja	RANDOM
insensibilidad	sensibilidad	ANT
juvenil	alguien	HYPER
meter	empuje	SYN
canal	igual	RANDOM
silla	miembro	RANDOM
escotilla	escotilla	PART_OF
muelle	paseo marítimo	PART_OF
hierro	infelicidad	RANDOM
diferenciado	indiferenciada	ANT
micrón	mm	PART_OF
agregar	totalidad	SYN
admirar	apretado	RANDOM
rizo	peinado	PART_OF
cervecería	trabajos	HYPER
posterior	torso	PART_OF
conservar	conservas	SYN
articular	inarticulado	ANT
Leche	pueblo	RANDOM
equilibrar	zapato	RANDOM
tirante	retortijón	SYN
pasar	salud	RANDOM
demonio	demonio	SYN
Por supuesto	inseguro	ANT
estante	librero	PART_OF
memoria	plataforma	PART_OF
trastorno	trastornado	HYPER
femenino	neutro	ANT
importador	capitalista	HYPER
perjudicial	inofensivo	ANT
cañón	billar	SYN
26	veintiseis	SYN
Tesauro	referencia	HYPER
burla	hechos	HYPER
respuesta	modo	HYPER
gramo	hg	PART_OF
legislar	gobernancia	HYPER
agudeza	inteligencia	HYPER
rigor	temperamento	HYPER
ubicación	estudio	ANT
compañero	Iniciar sesión	RANDOM
estrechez	amplitud	HYPER
modestia	reserva	SYN
fabricar	trastornar	RANDOM
colateral	indirecto	SYN
desequilibrio	equilibrio	ANT
comunalidad	individualidad	ANT
hervir	minuto	RANDOM
sincronizar	organizar	HYPER
ascendencia	sangre	SYN
zanja	atrincheramiento	PART_OF
fórmula	mensaje	HYPER
mm	cm	PART_OF
arco	trama	RANDOM
compartimiento	incluso	RANDOM
reversión	giro total	SYN
embriagador	temerario	SYN
apasionado	desapasionado	ANT
pintura	edificio	PART_OF
heterosexual	violento	RANDOM
flecos	remo	PART_OF
Costa	vertebrado	PART_OF
casa	radio	RANDOM
salir	Fruta	RANDOM
chalado	galletas	SYN
saturación	viveza	SYN
publicación	publicación	SYN
imprudente	prudente	ANT
anormalidad	normalidad	ANT
adelantarse a	ofertas	HYPER
conscientemente	inconscientemente	ANT
valiente	canabis	RANDOM
remolque	aparejo	PART_OF
anular una hipoteca	prevenir	SYN
envío	cargando	SYN
indescifrable	poco claro	SYN
picar	templado	RANDOM
bañera	planeta	RANDOM
alerón	avión	PART_OF
nacimiento	pintar	RANDOM
tropezón	ir	HYPER
secuencia	película	PART_OF
Organo	espada	RANDOM
circulo	saltar	RANDOM
fuente de la cabeza	fuente	HYPER
miseria	experimentar	RANDOM
peligro	condición	HYPER
repetición	emisión	HYPER
tamborileo	rollo	SYN
nada	contento	RANDOM
uretra	vulva	PART_OF
entrega	serie	PART_OF
acoso	conducta	HYPER
alertar a	baloncesto	PART_OF
amistoso	teatro	PART_OF
jacinto	jacinto	SYN
disminuido	aumentado	ANT
papada	homo	PART_OF
dl	dal	PART_OF
radio	rueda de carro	PART_OF
aterrorizar	susto	HYPER
gigante	apisonadora	SYN
hielo	detener	RANDOM
cenefa	tapiz	PART_OF
primario	secundario	ANT
vocalizar	enunciar	HYPER
aritmética	enorme	RANDOM
caliente	sonreír	RANDOM
microsegundo	segundo	PART_OF
snit	irritacion	HYPER
ministro	residencia	RANDOM
cómico	gracioso	SYN
almuerzo	televisión	RANDOM
mastoides	caja del cráneo	PART_OF
embotar	crudo	SYN
Cuarto	sufrir	RANDOM
cátodo	tubo	PART_OF
reincidente	reversión	SYN
exportar	importar	ANT
rama	positivo	RANDOM
centavo	Leona	PART_OF
pista	pista de aterrizaje	PART_OF
estruendo	clamor	SYN
pertenecer	referir	SYN
China	Novia	RANDOM
fabricar	sencillo	RANDOM
Perfecto	sentar	RANDOM
circunvolución	cerebro	PART_OF
cama	perder	RANDOM
perder	pérdida	SYN
merodeador	delincuente	HYPER
centro del campo	arena	PART_OF
hipnotizar	influencia	HYPER
alce	wapití	SYN
jade	puta	SYN
fondo	torso	PART_OF
bráctea	cáscara	HYPER
importar	raya	RANDOM
flotilla	agregación	HYPER
perezoso	historia	RANDOM
golpear	tropezón	SYN
Correa	camisa	PART_OF
amenazar	informar	HYPER
historicismo	concepto	HYPER
chusma	derrota	SYN
mejor	peor	ANT
conveniencia	inconveniencia	ANT
sano	insalubres	ANT
ejecutable	inaplicable	ANT
malla	en	PART_OF
vistoso	incoloro	ANT
sustento	mantenimiento	SYN
comestible	incomible	ANT
locura	sabiduría	ANT
America	recreo	RANDOM
hidrófila	hidrofóbico	ANT
salario	nómina de sueldos	PART_OF
muelle real	aparato de relojería	PART_OF
evitación	regate	SYN
mitigado	no mitigado	ANT
imperioso	fanfarrón	SYN
insinceridad	sinceridad	ANT
appointive	electivo	ANT
vida	relajarse	RANDOM
registrado	no registrado	ANT
tálamo	prosencéfalo	PART_OF
dal	hl	PART_OF
doblar	ennoblecer	HYPER
abajo	debajo	SYN
equipamiento	movilización	HYPER
núcleo	reactor	PART_OF
Aparecer	experimentar	RANDOM
imperceptiblemente	perceptiblemente	ANT
embrague	embrague	PART_OF
establecer	porque	HYPER
aula	aula	SYN
comercial	publicidad	HYPER
con alas	sin alas	ANT
mármoles	ingenio	SYN
adición	sustracción	ANT
tejón	vejar	HYPER
gatito	enseñar	RANDOM
actor	templado	RANDOM
color	brillo	SYN
uro	buey	HYPER
atleta	dominar	RANDOM
idioma	playa	RANDOM
belicosidad	agresividad	HYPER
intolerable	tolerable	ANT
escrúpulo	vacilar	HYPER
onz. 	libra	PART_OF
bar	tú	RANDOM
laca	embellecer	HYPER
accidente	restringir	RANDOM
hermosa	valor	RANDOM
orientar	desplazar	HYPER
episcopado	episcopado	SYN
inferioridad	superioridad	ANT
asimetría	simetría	ANT
monolingüe	plurilingüe	ANT
circulo	ideología	RANDOM
especialidad	especialización	SYN
veleta	hélice	PART_OF
Uptick	relación comercial	HYPER
vergonzoso	chocante	SYN
achicoria	achicoria	PART_OF
rugido	gemido	SYN
ausencia	presencia	ANT
chalado	loco	SYN
yaya	antepasado	HYPER
invariable	variable	ANT
trono	poder	PART_OF
disruptivo	preocupado	SYN
playa	valores	RANDOM
violín	reparar	HYPER
caña	sartén	PART_OF
chorro	explosión	SYN
ruidosamente	suavemente	ANT
ahogo	circuito	PART_OF
destructor	obrero	HYPER
carburador	carburador	SYN
absorción	extinción	PART_OF
hernia	lesión	HYPER
RAID	contender	HYPER
animar	medida	HYPER
austero	inflexible	SYN
asimétrico	asimétrico	SYN
factible	viable	SYN
siglo	milenio	PART_OF
sopladura	aerovía	PART_OF
malo	móvil	RANDOM
nube	poderoso	RANDOM
becerro	zapato	RANDOM
esperanza	jarra	RANDOM
vocación	vocación	SYN
entrar	malhechor	HYPER
determinado	indeterminado	ANT
tranvía	instrumentación	HYPER
inventario	producto	HYPER
maniobra	táctica	SYN
segregación	mitosis	PART_OF
lección	pedagogía	PART_OF
humanidad	bolígrafo	RANDOM
servicial	poco útil	ANT
planeo	navegación	SYN
almuerzo	justicia	RANDOM
base	escritor	RANDOM
maxi	midi	ANT
conflagración	ocurrencia	HYPER
agitación	calma	ANT
perno	bisagra	PART_OF
ignorancia	hecho	RANDOM
resistencia	circuito	PART_OF
parcialidad	acto	RANDOM
colina	paseo	RANDOM
portero	portero	SYN
imagen	fumar	RANDOM
factor	núcleo	PART_OF
protuberancia	suma	SYN
endurecer	bordillo	HYPER
preparado	desprevenido	ANT
juzgar	juicio	SYN
espumoso	todavía	ANT
dormitorio	morada	PART_OF
dificultad	facilitar	ANT
pelea	lucha	HYPER
orfebre	fabricante	HYPER
me gusta	fuera de	RANDOM
látex	emisión	HYPER
negro	dañar	RANDOM
rayo de luna	luz de la luna	PART_OF
hoja	cepillo	RANDOM
rama	división	RANDOM
cilindro	escafandra autónoma	PART_OF
entumecido	alterar	HYPER
apoyarse	Rico	ANT
7	siete	SYN
encuesta	caballo	PART_OF
144	bruto	SYN
racha	sucediendo	HYPER
insubordinación	subordinación	ANT
recuadro	prenda	PART_OF
condicional	incondicional	ANT
ligero	ocioso	RANDOM
niñera	niñera	SYN
activo	tono	RANDOM
aconsejable	desaconsejable	ANT
kayac	canoa	HYPER
tratada	sin tratar	ANT
recoger	fonógrafo	PART_OF
cómplice	confederado	SYN
menear	menear	HYPER
producto	mercancía	HYPER
suelto	viaje	RANDOM
periquito	periquito	SYN
cabestro	tocados	HYPER
aro	barril	PART_OF
perinatal	prenatal	ANT
deflación	inflación	ANT
cianotipo	borrador	SYN
sequedad	lacónicamente	SYN
palanqueta	palanca	SYN
escudo	mierda	PART_OF
oxígeno	mentira	RANDOM
continental	intercontinental	ANT
cuentista	mentiroso	HYPER
caballo	fuerza	HYPER
escape	auto	PART_OF
chacal	canino	HYPER
carriles	tranvía	PART_OF
influencia	modificar	HYPER
inhalar	inspirar	SYN
ruidoso	democracia	RANDOM
adjunto	separado	ANT
degradación	promoción	ANT
espacio de rastreo	edificio	PART_OF
premio	trofeo	SYN
cancelar	rasguño	SYN
agnóstico	gnóstico	ANT
contraste	diferir de	HYPER
enteramente	exclusivamente	SYN
sector	campo de batalla	PART_OF
compartimiento	ángel	RANDOM
cifrar	cremallera	SYN
tránsito	infraestructura	PART_OF
aullido	clamoroso	SYN
pista	tranvía	PART_OF
Nota	humanidad	RANDOM
pirata	felón	HYPER
guayaba	guayaba	PART_OF
ocioso	cepillo	RANDOM
múltiple	soltero	ANT
detectado	sin ser detectados	ANT
motored	motorizado	SYN
familiaridad	la falta de familiaridad	ANT
imaginación	puerta	RANDOM
nada	dirigir	RANDOM
rueca	esfera	HYPER
aturdir	bordillo	HYPER
rastreo	trailing	SYN
mutuamente	recíprocamente	SYN
jefe	político	HYPER
nación	acera	RANDOM
caña	espiga	PART_OF
aleta de la cola	auto	PART_OF
ejemplar	modelo	SYN
trueno	pronunciar	HYPER
tornillo	molde	RANDOM
imprecisión	precisión	ANT
eludir	evadir	SYN
parque	caucho	RANDOM
mantequilla	vuelo	RANDOM
Ponche de huevo	puñetazo	HYPER
accesible	inaccesible	ANT
cuenco	declaración	RANDOM
inmutable	mudable	ANT
epíteto	caracterización	HYPER
dumping	mercantilismo	HYPER
hemisferio	cerebro	PART_OF
remisión	rescate	HYPER
figura	soma	SYN
tapa	vestíbulo	RANDOM
miseria	regalo	RANDOM
sudario	virar	SYN
pobreza	riqueza	ANT
perder	experimentar	RANDOM
escalera	escalera	PART_OF
Respaldados	escotado por detrás	ANT
parquet	teatro	PART_OF
paso	perca	PART_OF
multinomial	polinomio	SYN
movimiento	ver	RANDOM
de principios	poco escrupuloso	ANT
arriesgado	dudoso	SYN
contentamiento	descontento	ANT
somorgujo	mocasín	HYPER
implorar	solicitud	HYPER
permitir	estimar	HYPER
forte	piano	ANT
cockamamie	mentecato	SYN
maldición	golpe	SYN
cremallera	fijación	HYPER
contratista	alguien	HYPER
downtick	Uptick	ANT
bofetada	manga	PART_OF
remitir	Espere	HYPER
gutural	consonante	HYPER
terreno de camping	sitio	HYPER
Hao	polla	PART_OF
plebeyo	sucio	SYN
cadera	pelvis	PART_OF
tierra	empujar	RANDOM
masa	moolah	SYN
empleo	desempleo	ANT
ósmosis	diálisis	PART_OF
Harper	músico	HYPER
picadura	viruela	PART_OF
convocar	exorcismo	PART_OF
agonista	antagonista	ANT
pálido	cadena	RANDOM
exacción	militarización	HYPER
costilla	comentario	HYPER
mordaz	espinoso	SYN
recuperable	irrecuperable	ANT
impolítico	diplomático	ANT
artificialmente	no natural	SYN
antera	florecer	PART_OF
cabaña	abrigo	HYPER
pareja	yugo	SYN
damisela	señorita	SYN
nublado	borroso	SYN
Clavo	brote	HYPER
gráficos	publicación	PART_OF
congelación	lesión	HYPER
Confusión	agravando	HYPER
Campaña	cruzada	SYN
nominativo	oblicuo	ANT
alegría	temperamento	PART_OF
hoja	dividir	RANDOM
respiradero	aerovía	PART_OF
acumular	conglomerado	SYN
turboventilador	turborreactor	PART_OF
popurrí	composición	HYPER
rata	coña	PART_OF
nevo	mar	HYPER
legal	ilegal	ANT
transportista	constructor	HYPER
inseguridad	seguridad	ANT
desfibradora	mediación	HYPER
absurdo	absurdo	SYN
picar	byte	PART_OF
cañón	bípedo	PART_OF
ocupado	apartamento	RANDOM
designado	nombrar	HYPER
gente	abstracción	HYPER
detenido	prisionero	HYPER
montón	apilar	SYN
disimilitud	semejanza	ANT
embotellamiento	bloquear	HYPER
panteísmo	teísmo	HYPER
diabético	víctima	HYPER
aterrizaje	escalera	PART_OF
aventuras	peligro	SYN
encendido	iluminación	SYN
salvaje	primitivo	HYPER
soplar	carta	RANDOM
carne	tener éxito	RANDOM
pecho	pierna	RANDOM
invasor	no invasiva	ANT
apuesta	piscina	PART_OF
cáustico	sulfuroso	SYN
codo	brazo	PART_OF
camilla	edificio	PART_OF
marta	carnívoro	HYPER
casa de te	edificio	HYPER
artillería	fuerza	HYPER
noche	Noche	PART_OF
gestual	no verbal	SYN
bar	salón	PART_OF
belleza	cruel	RANDOM
esquelético	vano	SYN
programado	no programada	ANT
excusable	perdonable	SYN
ecumenismo	credo	HYPER
aritmética	cacerola	RANDOM
familiaridad	la falta de familiaridad	ANT
rasgo	alguien	PART_OF
masticando	masticación	HYPER
nube	galaxia	RANDOM
modelo	modelo	HYPER
colgante	collar	PART_OF
distribuidor	afluente	ANT
cambio	jornada laboral	PART_OF
temido	horrendo	SYN
abundancia	escasez	ANT
mandioca	mandioca	PART_OF
alabarda	brazo	HYPER
palma	brazo	PART_OF
disuasión	desincentivo	SYN
antiguo	comida	RANDOM
limpiar	vestir	RANDOM
estudió	espontáneo	ANT
azul	picante	SYN
afecto	suave	RANDOM
conjuntivo	disyuntivo	ANT
falda	prenda	PART_OF
telómero	cromosoma	PART_OF
idolatrado	idolatrado	SYN
cura	pastor	SYN
hiperglucemia	hipoglucemia	ANT
episcopado	agrupamiento	HYPER
pulmón	instrucción	RANDOM
civil	sideral	ANT
olor	mejorar	HYPER
44	cuarenta y cuatro	SYN
apalancamiento	apalancamiento	SYN
en privado	en público	ANT
arco	puerta	RANDOM
corteza	médula	ANT
Al por menor	venta al por mayor	ANT
trapo	semana	HYPER
leptón	dracma	PART_OF
citación	extraer	HYPER
ocioso	neutrón	RANDOM
blandura	tolerancia	HYPER
disinclined	inclinado	ANT
compuerta	compuerta	PART_OF
sensación	mago	SYN
catedral	monasterio	PART_OF
empleo	desempleo	ANT
tripas	vísceras	SYN
rafe	escroto	PART_OF
micrómetro	milímetro	PART_OF
formalismo	imitación	ANT
cargado	borracho	SYN
cambio	motocicleta	RANDOM
preciso	incorrecto	ANT
movimiento	ligero	RANDOM
paloma	halcón	ANT
bloquear	lejos	RANDOM
reproducción	grabadora	PART_OF
aprensión	limpieza	HYPER
Muller	implementar	HYPER
productor	moldeador	HYPER
reloj	vegetal	RANDOM
melodioso	sin aire	ANT
documentada	indocumentado	ANT
carne	Hobby	RANDOM
cinabrio	bermellón	SYN
preferir	designado	HYPER
pulmón	día	RANDOM
alminar	mezquita	PART_OF
bronceado	bronceado	SYN
perder	mesa	RANDOM
convulsivo	espástico	SYN
alineación	organización	HYPER
suficiente	cantidad	HYPER
personificar	encarnar	HYPER
tina	vivienda	PART_OF
eje	lanza	SYN
hiato	interrupción	HYPER
lente	palabra	RANDOM
fibra de coco	fibra	HYPER
frescura	calma	HYPER
cinturón	victoria	RANDOM
pintado	sin pintar	ANT
prepucio	vulva	PART_OF
sudar tinta	babosa	SYN
cristiano	infeliz	RANDOM
marca	aburrimiento	RANDOM
necesitar	exigir	SYN
taxidermia	arte	HYPER
amígdala	garganta	PART_OF
espira	coña	PART_OF
plaga	Plaga	SYN
herir	templado	RANDOM
cristal de una ventana	edificio	PART_OF
celda	erguido	RANDOM
estafa	Pro	ANT
pobreza	riqueza	ANT
anual	perenne	ANT
propina	punta de flecha	PART_OF
micrómetro	milímetro	PART_OF
Fettuccine	pastas	HYPER
chalado	de nuez	SYN
imperturbable	imperturbable	SYN
insubordinación	subordinación	ANT
práctica	escritura	HYPER
ventosa	ventosa	PART_OF
montículo	loma	SYN
clasicista	romántico	ANT
naturalista	realista	SYN
ruidoso	cielo	RANDOM
marcador	letrero	HYPER
perder	Unión	RANDOM
proactivo	retroactivo	ANT
almendra	almendra	PART_OF
Shoji	encubierto	HYPER
frente	caja del cráneo	PART_OF
patinar	tolva	PART_OF
dinamismo	vigor	SYN
me gusta	ventilador	RANDOM
hueso	oír	RANDOM
perder	Moda	RANDOM
molesto	mortificante	SYN
desconectado	en línea	ANT
independencia	equipo	RANDOM
flagelo	esperma	PART_OF
antiguo	enfermedad	RANDOM
envasador	pie de página	HYPER
borracho	alisado	SYN
enfermedad	Pareja	RANDOM
arco	cuidado	RANDOM
avión	complejo	RANDOM
clase	droga	RANDOM
superproducción	invadir	SYN
vamp	Superior	PART_OF
consideración	personalidad	PART_OF
hipócrita	tramposo	HYPER
lengüeta	gancho	PART_OF
conejo	das	SYN
apariencia	desaparición	ANT
irresoluto	resuelto	ANT
armadura	refrigerador	PART_OF
de rasgo	atípicamente	ANT
camarada	compañero	SYN
ligero	individual	RANDOM
línea	maduro	RANDOM
hombro	prenda	PART_OF
raído	de pacotilla	SYN
reliquia de familia	patrimonio	PART_OF
marca	designado	HYPER
generalidad	particularidad	ANT
extraterritorial	territorial	ANT
salpicaduras	salpicar	SYN
cualitativo	cuantitativo	ANT
caña	cuadrúpedo	PART_OF
reunión	decir	HYPER
sinceridad	naturalidad	HYPER
elástico	artefacto	HYPER
herir	centrar	RANDOM
ng	miligramo	PART_OF
trono	morada	PART_OF
corte	tarjetas	PART_OF
caja	edificio	PART_OF
empalizada	rodear	SYN
agitar	despertar	SYN
belleza	ideal	HYPER
caliente	raro	RANDOM
falibilidad	infalibilidad	ANT
distancia	pose	HYPER
patinar	diapositiva	PART_OF
civil	militar	ANT
mesón	boeuf	PART_OF
beca	posición	HYPER
describir	elaborar	HYPER
kurta	prenda	HYPER
dibujante	dibujante	HYPER